 . . . 0 . . . . . .
 . . 0 0 0 . . . . .
 . . . 0 . . . . . .
 . . . . . . . . . .
 . M . . . . . 3 3 3
 . . . 2 2 2 S . . .
 . . . . . . . . . .
 . . . . . . . . . .
 . . . 1 1 . . . . 4
 . . 1 1 1 . . . . 4
