 . . . S . . . 1 1 .
 . . . 4 . . 1 1 1 .
 . . . 4 . . . . . .
 . . . . . . . . . .
 . . . . . . M . . .
 . . . . . . . . . .
 . 0 . . . . . 2 . .
 0 0 0 . . . . 2 . .
 . 0 . . . . . 2 . .
 . . . 3 3 3 . . . .
