 . . . 1 . . . . . .
 . . . 1 . . . . . .
 . . . 1 . . . . 0 .
 . . S 1 . . . . 0 .
 M . . . . . 4 . 0 .
 . . . . . . 4 . 0 .
 . . . . . . . . 0 .
 . . . . . . 3 . . .
 . . . . . . 3 . . .
 . 2 2 2 . . 3 3 . .
