 . . . . . . . 4 4 .
 . . . . 2 . . . . .
 . . . . 2 . . . . .
 . . . . 2 . . . S .
 . . . . . . . . . .
 . . . . . . . . M .
 . . . 1 . . . . . .
 . 1 1 . . 3 . . 0 .
 . 1 1 . . 3 . 0 0 0
 . . . . . 3 . . 0 .
