 . . . . . . . . 0 .
 . 1 . . . . 2 . 0 .
 1 . 1 . . 2 . . 0 .
 . 1 S . 2 . . 0 . 0
 . . . . . . . . . 0
 . . 4 . . M . . . .
 . . 4 . . . . . . .
 3 . . . . . . . . .
 . 3 . . . . . . . .
 . . 3 . . . . . . .
