 . . . . . . . . . .
 . . . . . . . . . .
 . . . . . . . . . .
 . 2 2 2 2 . 1 . . .
 . . . . . . 1 . . 3
 . . . S . . 1 . . 3
 . . . . . . 1 . . 3
 M . . . . . . . . .
 . . . 4 . 0 0 0 0 0
 . . . 4 . . . . . .
