 . . . . . . . . . .
 . . . . . . . . . .
 . . . 1 . . . . . .
 . M . 1 . . . . . .
 . . . 1 . 4 . . 0 .
 S . . 1 . 4 . . 0 .
 . . . . . . 4 . 0 .
 . 2 . . . . . . 0 .
 . 2 . . . . . . 0 .
 . 2 . 3 3 3 . . . .
