 . . . 0 . . . . . .
 . . 0 0 0 . . 4 4 .
 . . . 0 . . . . . .
 . . . . . . . . M .
 . . 1 1 . . . . . S
 . . 1 1 1 . 3 3 3 .
 . . . . . . . . . .
 . . . . . . . . . .
 . . . . . 2 2 2 . .
 . . . . . . . . . .
