 . . . 3 3 3 . M . .
 . . . . . . . . . .
 . . . . . . . . . .
 . . . . . . . . . .
 1 1 1 . . . . . . .
 . 1 1 . . . . 0 . .
 . . . . . . 0 0 0 S
 . . 4 . 2 . . 0 . .
 . . 4 . 2 . . . . .
 . . . . 2 . . . . .
