 . . 3 . . . . . 2 .
 . 3 . . . . . 2 . .
 3 . . . . . 2 . . .
 . . 4 4 . . . . . .
 . . . . . . . . . .
 . . 1 . . . . . . 0
 . 1 . 1 . . 0 0 0 .
 S . 1 . . . . 0 . 0
 . . . . M . . . . .
 . . . . . . . . . .
