 . 2 2 2 . . . . . .
 . . . . . . . . . .
 4 4 . . 1 1 . . . .
 . . . . 1 1 . . . .
 . . . . . . . . 0 .
 . . 3 . . . . 0 0 0
 . . . 3 3 3 . . 0 .
 . . . . . . . . S .
 . . . . . . . . . .
 . . . . . . . . . M
