 . . . . . S . . 4 .
 . . . 0 . . . . 4 .
 0 0 0 . . . 2 . . .
 . . . 0 . . . 2 . .
 . . . . . . . . 2 .
 . M . . . . . . . .
 . . . 3 . . . . . .
 . 1 . . 3 . 3 . . .
 1 . 1 . . 3 . . . .
 . 1 . . . . . . . .
