 4 4 . . 1 . . . . .
 . . . S . 1 1 . M .
 . 3 . . . 1 1 . . .
 . 3 . . . . . . . .
 . 3 . . . . 0 . . .
 . . . . . 0 0 0 . .
 . 2 . . . . 0 . . .
 . 2 . . . . . . . .
 . 2 . . . . . . . .
 . . . . . . . . . .
