 . . . . . . 1 1 1 1
 . . . . . . . . . .
 . M . . . . . . . .
 . . . . . . . 3 . .
 . . 2 . 0 . . 3 . 4
 . . 2 . 0 . . 3 . 4
 . . 2 . 0 . . . . .
 . . . . 0 0 S . . .
 . . . . 0 . . . . .
 . . . . . . . . . .
