 . . . 0 . . . . . .
 . S 0 0 0 . . . . .
 . . . 0 . . . 4 4 .
 . . . . . 2 . . . .
 . . . . 2 2 . 3 3 3
 . . . . . 2 . . . .
 . . . M . . . . . .
 . . . . . . 1 1 . .
 . . . . . . 1 1 . .
 . . . . . . . . . .
