 . . . . 2 . . 1 . .
 . . . 2 . . 1 . 1 .
 . . 2 . . . . 1 . .
 . 2 . . M . . . . .
 . . . . . . . . . .
 3 . . . 0 . . . . .
 . 3 . . . 0 0 0 . .
 . . 3 . 0 . . . . .
 . . . . . . . . . .
 . . . . . . S 4 4 .
