 . . . . . . 0 . . .
 . 4 . . 1 . 0 . M .
 . 4 . . 1 . 0 . . .
 . . 4 . 1 . 0 . . .
 . . . . 1 . 0 . . .
 . S . . . . . . . .
 . . . . . . . . . .
 3 3 3 . . . 2 2 2 .
 . . . . . . . . . .
 . . . . . . . . . .
