 . . . 3 3 3 . . . .
 . . . . . . . . . M
 2 . . . . . . . . .
 2 . . 0 . . . . S .
 2 . . 0 . . . . . .
 . . . 0 . 4 4 . . .
 . . . 0 . . . 4 . .
 . . . 0 . . . . . .
 . . . . . . . . . .
 . . . . . . 1 1 1 1
