 . . . . . . 4 4 . .
 . . . . . . . . . .
 . . S . . . . . . .
 . . 0 . . . . . . .
 . 0 0 0 . 3 3 3 . M
 . . 0 . . . . . . .
 . . . . . . . . . .
 2 . 1 1 . . . . . .
 2 . 1 1 1 . . . . .
 2 . . . . . . . . .
