 . . . . . 4 4 . M .
 . . . . . . . . . .
 . 0 . 0 . . . . . 2
 . . 0 . . . . . 2 .
 . . 0 . . . . 2 . .
 . . 0 . . . . S . .
 . . . . . . . . . .
 . . 3 . . . 1 . . .
 . 3 . . . 1 . 1 . .
 3 . . . . . 1 1 . .
