 . . . . . 0 . . . .
 . . . . . 0 . . . .
 . . 3 . . 0 . . . .
 . 3 . . 0 . 0 . . .
 3 . . . . . . . . .
 . . . . . . . . . .
 . . . . . 1 . . . M
 2 . . . 1 . 1 . . .
 . 2 . . . 1 . S 4 .
 . 2 2 . . . . . 4 .
