 . . 2 . . . . . . .
 . . 2 . . . . . 0 .
 . . 2 . . . . . 0 .
 . . 2 . . . . S 0 .
 . . . . . . . . 0 .
 1 . . . . . . . 0 .
 1 . 3 3 3 . M . . .
 1 . . . . . . . . .
 1 . . 4 . . . . . .
 . . . 4 . . . . . .
