 . . . . . 4 4 . . .
 . 2 . . . . . . . .
 . . 2 2 2 . . . . .
 . . . . . . . . . .
 3 3 3 . . . . . . M
 . . . . . . . 0 . .
 . . . . . . 0 0 0 .
 . . . 1 1 . . 0 S .
 . . . 1 1 . . . . .
 . . . . . . . . . .
