 . . . . . . . . 0 .
 . . . . 0 0 0 0 0 .
 . . . . . . . . . .
 . . . . . . 3 3 3 .
 . . . . . S . . . .
 . . 1 . . . . . . .
 . . 1 . . 2 2 2 . .
 . . 1 . . . . . . .
 . . 1 . . . . . . .
 M . . . . . 4 4 . .
