 . . 2 . . . . . . 4
 . S 2 . . . . 4 4 .
 . . 2 . . . . . . .
 . . . . . . . 0 . .
 . 3 3 3 . . . 0 . .
 . . . . . M . 0 . .
 . 1 . . . . . 0 . .
 . 1 . . . . . 0 . .
 . 1 . . . . . . . .
 . 1 . . . . . . . .
