 . . . 3 . . . 2 . .
 . . 3 . . 1 . . 2 .
 . 3 . . 1 . 1 . . 2
 3 . . . . 1 . . . .
 . . . . . . . . 4 .
 S . . . . . 0 . 4 .
 . . . 0 0 0 . . . .
 . . . . . . 0 . . .
 . . . . M . . . . .
 . . . . . . . . . .
