 . . M . . . . . . .
 . . . . . . . . 4 .
 . . . . 2 . . . 4 .
 . . . 2 2 2 . . . .
 1 1 . . . . . . 0 .
 1 1 . . . . S 0 0 0
 . . . . . . . . 0 .
 . . . 3 . . . . . .
 . . . 3 . . . . . .
 . . . 3 . . . . . .
