 . . . . . . . . . M
 . . . 0 . . . . . .
 0 0 0 . . . . . . .
 . 0 . 0 . . . . . 2
 . . . . . . . . 2 .
 . . . . 1 . . 2 . .
 . . . 1 . 1 . . . .
 . . . . 1 . . . 3 .
 . . . . . . . 3 . .
 4 4 . . . . 3 . . S
