 . . . 2 2 2 . . . .
 . . . . . . . . . M
 . . . 4 . . . . . .
 . . . 4 . . . 0 . 0
 . . . . . . 0 0 0 .
 . . . . . . . 0 . .
 . . . . . 3 . . . .
 1 1 . . . 3 . . . .
 1 1 . . . 3 . . . .
 . . . S . . . . . .
