 . 2 . M . . . . . .
 . 2 . . . . . . . .
 . 2 2 . . 4 . 0 . .
 . . . . . 4 . 0 . .
 . . 3 . . . . 0 S .
 . . 3 . . . . 0 . .
 . . 3 . . . . 0 . .
 . . . . . . . . . .
 . . . 1 1 1 1 . . .
 . . . . . . . . . .
