 . . . . . . . . . .
 . . . . . 0 . 0 . 4
 . . . M . . 0 . . 4
 . 3 . . . . 0 . . 4
 . . 3 . . . 0 . . .
 . . . 3 . . . . . .
 2 . . . . . 1 . . .
 . 2 S . . 1 . 1 . .
 . . 2 . . . 1 . . .
 . . . . . . . . . .
