 . . . . . S . . . .
 . . . 2 . . . . . .
 . . 2 . . . . 0 . 0
 . 2 . . . 4 . . 0 .
 . . . . . 4 . . 0 .
 . . . . . . . . 0 .
 . . . 1 1 . . . . .
 . M . 1 . 1 . . . 3
 . . . . 1 . . . 3 .
 . . . . . . . 3 . .
