 . . . . . 1 . . . .
 . . . . 1 . 1 . . .
 . . 3 . . 1 . . . .
 . 3 . . . . . 2 . .
 3 . . M . . . . 2 .
 . . . . . . 0 . . 2
 . . . 0 0 0 . . . .
 . . 0 . . . 0 . 4 4
 . . . . . . . . . .
 . . . . . S . . . .
