 . . . M . . . . . .
 . . . . . . S . . .
 . . . 1 . . . . . 2
 . . 1 . 1 . . . 2 .
 . . . 1 . . . 2 . .
 . . . . . . . . . .
 . . . . . . . . 4 .
 3 . . . 0 . . . . 4
 . 3 . . . 0 0 0 . 4
 . . 3 . 0 . . . . .
