 . 1 . . . . . . . .
 . 1 . . . . . . . .
 S 1 . . 2 2 2 . . .
 . 1 . . . . . . . .
 . . . . . . . . . M
 . . . 3 3 3 . . . .
 . . . . . . . . . 4
 . 0 0 0 0 0 . 4 4 .
 . . . . . . . . . .
 . . . . . . . . . .
