 . 4 . . . . S . 0 .
 . 4 . . . . . 0 0 0
 . . . . . . . . 0 .
 . . . . . . . . . .
 . . . . . 1 1 . . .
 2 . . . . 1 1 . M .
 2 . . . . . . . . .
 2 . . 3 . . . . . .
 . . . 3 . . . . . .
 . . . 3 3 . . . . .
