 . . S . 0 . 0 . . .
 2 . . 0 . 0 . . . .
 . 2 . . . 0 . . 4 4
 . . 2 . . 0 . . . .
 . . . . . . . . . .
 . . . . . . . . . .
 . 1 . . . . 3 . . M
 1 . 1 . . 3 . . . .
 . 1 . . 3 . . . . .
 . . . . . . . . . .
