 . . 2 . 4 . . . . .
 . 2 . . 4 . . . . .
 2 . . . . . . . . .
 2 . . . . . M . . .
 . . . . . . . . . .
 . 0 . 0 . . . . . .
 . . 0 . . . S . 1 .
 . . 0 . 3 . . 1 . 1
 . . 0 . . 3 . . 1 .
 . . . . . . 3 . . .
