 . . . . . . . . . .
 . . . 1 . . S . 2 .
 . . 1 . 1 . . 2 . .
 . . . 1 . . 2 . 2 .
 . . . . . . . . . .
 0 . 0 . . . 4 4 . .
 . 0 . . . . . . . .
 . 0 . . . 3 . . . .
 . 0 . M . . 3 . . .
 . . . . . . . 3 . .
