 . . . . 3 3 3 . . .
 . 0 . . . . . . . .
 . 0 . . . . . . . .
 . 0 . 1 1 1 1 . . .
 . 0 . . . . . . . M
 . 0 0 . . . . . . .
 . . . . . . . . . .
 . S . . . . . . . .
 . . . 2 2 2 . 4 4 .
 . . . . . . . . . .
