 4 . . . . 3 . . . .
 4 . . . . . 3 3 3 .
 . . . . . . . . . .
 . . . . . . . . . .
 . . 0 0 0 0 0 . . .
 . . . . . . . . . .
 2 2 2 . . . M . . .
 . . . . . . . . . .
 . . . 1 1 1 1 . . .
 . . . . . S . . . .
