 . 1 . . . . 4 4 . .
 . 1 . . 0 . . . . .
 . 1 1 . 0 . . . . .
 . 1 . . 0 . . . . .
 . . . . 0 . . M . .
 . . . . 0 . . . . 3
 . . . . . . . . . 3
 . . . . . . . . S 3
 2 2 2 . . . . . . .
 . . . . . . . . . .
