 . . . . . 3 . . . .
 . . 2 . . 3 . M . .
 . . 2 . . 3 . . . .
 . . 2 . . 3 . . . .
 . . . . . . . . . .
 . 0 0 0 0 0 . . . .
 . . . . . . . . . .
 . . . . . . . . . .
 . . 4 . . . . . . .
 . . 4 . S . 1 1 1 1
