 . 0 . . . . . . . .
 . 0 . . . . . 4 4 .
 . 0 . . . . . . . .
 . 0 . . . . . . . .
 . 0 . . . . . . . .
 . . . 1 . . 3 3 3 .
 . M . 1 . . . . . .
 . . . 1 . . . . 2 .
 . . . 1 . . . . 2 .
 . . . . . . S . 2 2
