 . . . . . . . . . .
 . . . . . . 2 2 2 .
 . . . . . . . . . .
 . . M . . . . . . .
 . . S . . . 3 3 3 .
 . . . 1 . . . . . .
 . . . 1 1 . . . . .
 . . . 1 . . . . . .
 4 . . 1 . 0 0 0 0 0
 4 . . . . . . . . .
