 . . . S . 0 . . . .
 . . . . 0 0 0 . . .
 . . . . . 0 . . . .
 . . . M . . . . . .
 . . . . . . . . 1 1
 . . . . 3 . . . 1 1
 . 3 3 3 . . . . . .
 . . . . . . 2 . . .
 . . . . . . 2 . . .
 . 4 4 . . . 2 . . .
