 . . . . . . . . . .
 . . . . . . . . . .
 . . 2 2 2 . . . 1 .
 . . . . . . . . 1 .
 . . . . . . . . 1 S
 . . . . . . . . 1 .
 . 0 0 0 0 0 . . . .
 . . . . . . . 3 . .
 . . 4 4 . . . 3 . .
 M . . 4 . . . 3 . .
