 . . . . . 1 1 . . .
 . . . . . 1 1 . . .
 . . . . . . . . . .
 2 . . . . . . . 4 4
 2 . . . . . . . . .
 2 2 . . . . 3 . . .
 . . . . . S 3 . . .
 . 0 . . . . 3 . . .
 0 0 0 . . . . . . .
 . 0 . . . . . . M .
