 . . . 1 1 1 1 . . .
 . . . . . . . . . .
 . . . . 0 . 3 3 3 .
 . S . . 0 . 3 . . .
 . . . . 0 . . . . .
 2 2 2 . 0 . . . . .
 . . . . 0 . . . . .
 . . . . . . . . . .
 . . . . M . 4 . . .
 . . . . . . 4 . . .
