 . . . . . . . . . .
 . . 0 . 0 . . 1 . .
 . . . 0 . . 1 . 1 .
 . . . 0 . . . 1 . .
 . . . 0 . M . . S .
 . . . . . . . . . .
 4 . . . . . 2 . . 3
 4 . . . . 2 . . 3 .
 . 4 . . 2 . . 3 . .
 . . . . . . . . . .
