 . . . . . . . . . .
 . . . . . . . . . .
 . . . . . . . . 2 2
 . 0 0 0 0 0 . . 2 .
 . . . . . . . . 2 .
 . . . M . . . . . .
 . . . . . . . 3 . .
 . . 1 1 1 1 . 3 . .
 . . . . . S . 3 . .
 . . . 4 4 . . . . .
