 . . . . . . . . . .
 4 4 . 0 . . . . . .
 . . . . 0 0 0 . . .
 . . . 0 . . . . . .
 . M . S . . . . . .
 . . . . . . 1 . . .
 . . . . . 1 . 1 . .
 . 2 . . . . 1 . . 3
 . . 2 . . 1 . . 3 .
 . . . 2 . . . 3 . .
