 . . . . . . . 3 3 3
 . . 0 . . . S . . .
 . . 0 . . . . . . .
 M . 0 . . . . 2 2 2
 . . 0 . 1 . . . . .
 . . 0 . . 1 1 1 1 .
 . . . . . . . . . .
 . . . . . . . 4 . .
 . . . . . . . 4 . .
 . . . . . . . . . .
