 . . . S . . . . . .
 . . . . 1 1 1 1 . .
 . . . . . . . . . .
 . 2 2 2 2 . . 4 . .
 . . . . . . . 4 . .
 . 3 . M . . . . . .
 . 3 . . . . . . . .
 . 3 . 0 0 0 0 0 . .
 . . . . . . . . . .
 . . . . . . . . . .
