 . . . . . 1 1 . . 3
 . . . . . 1 1 . . 3
 . . . . S . . . . 3
 . 0 . 0 . . . . . .
 . . 0 0 0 . . . . .
 . . . 0 . . . . . M
 . . . . . . . . . .
 . . . . . . . 4 4 .
 . . 2 2 2 . . . . .
 . . . . . . . . . .
