 . . . 2 . . . . . .
 . . . 2 . . 3 . . .
 . . . 2 . . 3 . . .
 . . . . . . 3 . . .
 . 0 0 . S . . . . .
 . 0 . . . . . . . 1
 . 0 . 4 . . . . . 1
 . 0 . 4 . . . . . 1
 . 0 . . . M . . . 1
 . . . . . . . . . .
