 . . . . . . . . . .
 . . . . . 3 . . . .
 . . . . . 3 . . 0 .
 . . . . 3 3 . 0 0 0
 . . . . . . . . 0 .
 . 4 4 . . . . . . .
 . . . . 1 1 . . . .
 . . . . 1 1 . . . .
 . . . . . S . . . .
 . 2 2 2 . . . . . M
