 2 . . . . . . . . .
 . 2 2 2 . 4 . . . .
 S . . . . 4 . . . .
 . 1 1 . . . . . . .
 . 1 1 . . . . . 0 .
 . . . . . . . 0 0 0
 . . . . . M . . 0 .
 . . . . . . . . . .
 . 3 3 3 . . . . . .
 . . . . . . . . . .
