 . . . . . . . . . 3
 . . . . . . . . . 3
 . . . . . S . . . 3
 . . . . . . . . . .
 . 2 2 2 2 . . . . M
 . . . . . . . 0 . .
 . . . . . . 0 0 0 .
 . 4 . 1 1 . . 0 . .
 . 4 . 1 1 . . . . .
 . . . . . . . . . .
