 . . . . . . 4 . . .
 . . . 3 . . 4 . . .
 . S . . 3 . . . . 2
 . . . . . 3 . . 2 .
 . 0 0 0 . . . 2 . .
 . . 0 . . . . . . .
 . . 0 . . . 1 . . .
 . . 0 . . 1 . 1 . .
 . . . . . . 1 . . .
 . . M . . . . . . .
