 . . 2 2 2 . . . . .
 . . . . . . M . . .
 . . . . . . . . . .
 . . . . . 0 0 0 0 0
 . . . . . . . . . .
 . . . . . . . . . .
 . . . . . 1 . 4 4 .
 . S . . . 1 . . . .
 3 3 3 . . 1 . . . .
 . . . 3 . 1 . . . .
