 . . . . . . . . . .
 . . . . . . . . 4 4
 . . 2 . 1 1 . . . .
 . . 2 . 1 1 . . . .
 . . 2 . . . . . . .
 . . . . 3 3 3 . . 0
 . . . . . . . . 0 .
 M . . . . . . 0 0 0
 . . . . . . . . 0 .
 . . S . . . . . . .
