 . . 1 1 1 1 . 4 . .
 . . . . . . . 4 . .
 . . . . . . . . . .
 . . . . 0 0 0 0 0 .
 . . . . . . . . . .
 . . . . . . . . . 2
 . . . . . . . . . 2
 . . . . . . . 3 . 2
 . . . . . . 3 3 . .
 . . . . M S . 3 . .
