 . . . 4 . . . 2 . .
 . . . 4 . . 2 . . .
 . M . . . 2 . . . .
 . . . . . . . . . .
 . . . 1 . . . . . .
 . . 1 . 1 . 0 . 0 .
 . . . 1 S . . 0 . .
 3 . . . . . . 0 . .
 . 3 . . . . . 0 0 .
 . . 3 . . . . . . .
