 . . . 4 4 . . 0 . .
 . . . . . . 0 0 0 .
 . . 1 1 . . . 0 . .
 . . 1 1 . . . . . .
 . . . . . . . . . .
 2 2 2 . S . . . . .
 . . . . . . . . 3 .
 . . . . . . . 3 . .
 . . . . . . . 3 . .
 . M . . . . . 3 . .
