 1 1 . . . . 3 3 3 .
 1 1 . . . . . . . .
 . . . . . . . . . .
 . M . . . . . 2 2 2
 . S . . . 4 . . . .
 . 0 . . 4 4 . . . .
 0 0 0 . . . . . . .
 . 0 . . . . . . . .
 . . . . . . . . . .
 . . . . . . . . . .
