 . . . . . S . . . .
 . . . . . . . . . .
 . . . 0 . . . . . .
 . . . 0 . . . . . .
 . . . 0 . 4 . . 2 .
 . . 0 0 . 4 . . 2 .
 1 . . 0 . . . . 2 .
 1 . . . . . . . . .
 1 . . M . . . 3 3 3
 1 . . . . . . . . .
