 . . . M . . . . . .
 . . . . . . . . . .
 . . . . S . . 2 2 2
 . 0 0 0 0 0 . . . .
 . . . . . 0 . . . .
 . . . . . . . . 3 .
 . . . 4 4 . . . 3 .
 . . . . . . . . 3 .
 . . . . . . . . . .
 . 1 1 1 1 . . . . .
