 . . . . . M . . . .
 . . 0 . . . . . . 2
 . . 0 . . . . . . 2
 . 0 0 0 . S . . . 2
 . . 0 . . 1 1 . . .
 . . . . . 1 1 . . .
 . . . . . . . . . .
 . . . . . . . . . .
 3 3 3 . . . 4 4 . .
 . . . . . . . . . .
