 . . . . . . . . . .
 4 . . . . . M . . .
 4 . . . . . . . . .
 . . . . . . . 1 . .
 0 0 0 0 0 . . 1 . .
 . . . . . . . 1 . .
 . . . . . . . 1 . .
 . . . . . . . . . 2
 . . . S . . . . . 2
 . 3 3 3 3 . . . . 2
