 . . . . . . . . . .
 . . . . . . . . . 4
 . . . . . . . 0 . 4
 . M . . 0 0 0 . . .
 . . . . . . . 0 . .
 . . . 1 . . . . 0 .
 . . 1 . 1 . . . . .
 3 S . 1 . . 2 . . .
 . 3 . . . . . 2 . .
 . . 3 . . . . . 2 .
