 . . . . . . . . . .
 . . . . 1 1 . . . .
 . . . . 1 1 . . . .
 . . . . . . . . . M
 . . . . . . . . . .
 . . 0 . . 2 2 2 . .
 . . 0 . . . . . . .
 . 0 0 0 . . . 3 3 3
 . . 0 . . . . . . .
 . S . . . . . . 4 4
