 . . . . . . . 3 3 3
 . 2 2 2 . S . . . .
 . . . . . . M . . .
 . . . . . . . . . .
 . . . . . 4 4 . . .
 . . . 1 . . . . 0 .
 . . . 1 . . . . 0 0
 . . . 1 . . . . 0 .
 . . . 1 . . . . 0 .
 . . . . . . . . 0 .
