 . . . . 2 2 2 . . .
 . . . . . . . . . .
 . . . S . . . 3 . .
 . . 0 . . . 3 3 3 .
 . 0 0 0 . . . . . .
 . . 0 . . . . . . .
 . . . . . . . . . .
 . . . 1 1 . . . . .
 4 . . 1 1 . . . M .
 4 . . . . . . . . .
