 . . . . . . . . . .
 . 2 2 2 . 4 . . . .
 . . . . . 4 4 . . M
 . . . . . . . . . .
 . 1 . . . . . . . .
 . 1 . . . . . . 0 .
 . 1 . . . S . . 0 .
 . 1 . . . . 3 . 0 .
 . . . . . . 3 . 0 .
 . . . . . . 3 . 0 .
