 . . . . . . . . . .
 S . . . . . . . . .
 . . . . . . 1 1 . .
 . . 0 . . . 1 1 . .
 . 0 0 0 . . . . . .
 . . 0 . . . . 3 . .
 . . . . . . . 3 3 3
 . . 4 4 . 2 . . . .
 . . . . . 2 . . . M
 . . . . . 2 . . . .
