 . 0 . . . . . . . .
 . . 0 0 0 . 3 . . .
 . 0 . . . . . 3 . .
 . . . . . . . . 3 S
 4 4 4 . . . . . . .
 . . . . . . . . . .
 . . . . . . . 2 . .
 M . . 1 . . . . 2 .
 . . 1 . 1 . . . . 2
 . . . 1 . . . . . .
