 . . . . . 1 . . . .
 . 1 1 1 1 . . . M .
 . . . . . . . . . .
 . . . . . . . . . .
 . . . . . . . . . .
 0 0 0 0 0 . . . . .
 . . . . . . . . . .
 . . . . 4 4 . . . .
 . . . . . . . . . .
 2 2 2 . . 3 3 3 . S
