 . 2 . . . . . . . .
 . 2 . . . . . . . .
 . 2 . 3 3 3 . . . .
 . . . . . . . . . .
 . M . . 1 1 1 1 . .
 . . . . . . . . . .
 . . . . . . 0 . . .
 . . . . 0 0 0 0 0 .
 . . 4 . . . . . . .
 . . 4 . . S . . . .
