 . . . . . 4 4 S . .
 . . 1 . . . . . 0 .
 . . 1 . . . . . 0 .
 . . 1 . 2 2 2 . 0 .
 . . 1 . . . . . 0 .
 . . . . . . M . 0 .
 . . . . . . . . . .
 . . . . . . . . . .
 . . . . . . 3 . . .
 . . . . . 3 3 3 . .
