 . . . . . . . 2 . .
 . . . . . . . . 2 .
 . . . . 3 . . . . 2
 . . . . . 3 . . . .
 . . . . . . 3 . . .
 . . 0 . 0 . . . . .
 4 . . 0 . . . 1 . .
 4 4 . 0 . . 1 . 1 .
 . . . 0 . . . 1 . .
 S . . . . M . . . .
