 . M . . . 2 2 2 . .
 . . . . . . . . . .
 . . . . . 0 . . . .
 . . 4 . 0 0 0 . 1 1
 . . 4 S . 0 . . 1 1
 . . . . . . . . . .
 . . . . . . . . . .
 . . . . . . . . . .
 . . . . 3 3 3 3 . .
 . . . . . . . . . .
