 . . . . . . . . . 4
 . . . . . . . . . 4
 . . . . . . . . . .
 0 0 0 0 0 . . . . .
 0 . S . . . 2 2 2 .
 . . . . . . . . . .
 . . . . 1 . . . . .
 . . . . 1 . . . M .
 3 3 3 . 1 . . . . .
 . . . . 1 . . . . .
