 S . . . 1 . . . 4 4
 . . . 1 . 1 . 4 . .
 . 3 . . 1 . . . . .
 . . 3 . . . . . . .
 . . . 3 . . . . M .
 . . . . . . . . . .
 . 0 . 0 . . . 2 . .
 . . 0 . . . . . 2 .
 . . 0 . . . . . . 2
 . . 0 . . . . . . .
