 0 . . . . 4 4 . . .
 . 0 S . . . . . . .
 . 0 . . . . . . . .
 . 0 . . . . 2 . . .
 0 . 0 . . 2 . . . .
 . . . . 2 . . 1 . .
 . M . . . . 1 . 1 .
 . . . . 3 . . 1 . .
 . . . . . 3 . . . .
 . . . . . . 3 . . .
