 . . . . . . M . . 0
 . . . . . . . . 0 .
 . . . . . . . . 0 .
 1 1 1 1 . . . . 0 .
 . . . . . . . . 0 .
 . 4 4 . . . . . 0 .
 . . . . . 2 . . . .
 . . . . . 2 S . . .
 . 3 3 3 . 2 . . . .
 . . . . . . . . . .
