 . . . . 3 3 3 . 1 .
 . . . . . . . . 1 S
 . . . 2 . . . . 1 .
 . . . 2 2 2 . . 1 .
 . . . . . . . . . .
 . . . . . . . . . .
 . . . . . . . . . .
 . . . M . . . 4 4 .
 . . . . . . . . . .
 . . . 0 0 0 0 0 . .
