 . . . . . . . . . .
 . . . 2 2 2 . . . .
 . . . . . . . . . .
 . . . 3 . . . . . .
 . . . 3 S . . . . .
 4 . . 3 . . 1 1 1 .
 4 . . . . . . 1 1 .
 . . . 0 . . . . . .
 M . 0 0 0 . . . . .
 . . . 0 . . . . . .
