 . . . . . . 1 1 1 1
 . . . . . . . 1 . .
 . . . . . 2 . . . .
 . . . . . 2 . 3 . 4
 . . . . . 2 . 3 . 4
 . . . . . . . 3 . .
 0 0 0 0 0 . . . . .
 . . . S . . . . . .
 . . . M . . . . . .
 . . . . . . . . . .
