 S . . . . M . . . .
 . . . . . . . . . .
 . 0 0 0 0 0 . . 4 .
 . . . . . . . . 4 .
 . . . . . . . . . .
 . . . . . . . 2 . 3
 . . . . . . . 2 . 3
 . . . . . . . 2 . 3
 . . . . . . . . . .
 . 1 1 1 1 1 . . . .
