 . . . . . . . . . .
 . 4 . . . 3 . . . .
 4 . . . . 3 . . . .
 4 . . . . 3 . . . .
 . . 0 . . . S . . .
 . 0 0 0 . . . . . .
 . . 0 . . . . . . .
 M . . . . . . . 2 .
 . . . 1 1 . . . 2 .
 . . . 1 1 . . . 2 .
