 . . . . . . . . . .
 . . . . . . . . . .
 . . . . 0 0 0 0 0 S
 . . . 0 . . . . . .
 . . . . . 2 2 2 . .
 . 3 3 3 . . . . . 4
 . . . . . . . . . 4
 . . . . . . . . . .
 . . . . . . 1 1 1 1
 . . . M . . . . . .
