 . . . . . . . . . .
 . . 1 . . . . . . 3
 . . 1 . . . . . . 3
 . . 1 . . . . . . 3
 . . 1 . . . . . . .
 2 . . . . . . . . 4
 2 2 2 . . S . . . 4
 . . . . . . . . . .
 . . . . . 0 0 0 0 0
 . . M . . . . . . .
