 . . . 1 1 . . . . .
 . . . 1 1 . . . . .
 . . 1 . . . . . . .
 . . . . . . . . 4 4
 . . . . . . S . . .
 . . . . . 0 . . . .
 . . 2 . 0 0 0 . . .
 . . 2 . . 0 . . . 3
 . . 2 . . . . . . 3
 . . . . . . M . . 3
