 M . . . . . 0 . . .
 . . . 0 0 0 . . . .
 . . . . . . 0 . . .
 2 . . . . . . . . .
 . 2 . . . . . . . .
 . . 2 . . . . . . .
 . . . . 1 . . . . S
 4 . . 1 . 1 . . 3 .
 4 . . . 1 . . 3 . .
 4 . . . . . 3 . . .
