 . . 4 . . . 3 . . .
 . . 4 . . . 3 . . .
 . . . . . . 3 . M .
 . . . . . . . . . .
 . . . . . . . . . .
 2 S . . . . . . 0 .
 2 . . . . . . 0 0 0
 2 . . . . . . . 0 .
 . . . . 1 1 . . 0 .
 . . . . 1 1 . . . .
