 . . . . . . . . . .
 . . . 2 2 2 . . . .
 . . . . . . . . . .
 . . . . . . . 0 . .
 . . . . . . 0 0 0 .
 3 . . 4 . . . 0 . .
 3 . . . 4 4 . . . .
 3 . . S . . . . . .
 . . . . . M . 1 1 .
 . . . . . . . 1 1 .
