 . . . . . . 1 . . .
 . . . . . . 1 . . .
 4 4 . . 0 . 1 . . .
 . . . . 0 S 1 . . 3
 . . . . 0 . . . . 3
 . . . . 0 . . . . 3
 . . . . 0 . . . . .
 . . . . . . . . . .
 2 . . . . . . . . .
 2 2 2 . . . . . . M
