 . 4 . . . . . . . .
 . 4 . . . 1 1 1 . .
 . . . . . . 1 1 . .
 M . . . . . . . . 2
 . . . . . . . . . 2
 . . S . . . 0 . . 2
 . . . 3 . 0 0 0 . .
 . . . 3 . . 0 . . .
 . . . 3 . . . . . .
 . . . . . . . . . .
