 4 4 . . . . 1 . . .
 . . . . 1 1 . . . .
 . 3 . . 1 1 . . . .
 . 3 . . . . . . M .
 . 3 . . S . . . . .
 . . . . . . . . . .
 . . . 0 . . . 2 . .
 . . 0 0 0 . . 2 . .
 . . . 0 . . . 2 . .
 . . . . . . . . . .
