 . . . . M . . 2 . .
 . 4 4 . . . 2 . . .
 4 . . . . 2 . . . .
 . . S 0 . . . . . .
 . . . . 0 0 0 . . .
 . . . 0 . . . . . .
 . . . . . . . . . .
 . . 3 . . . . 1 . .
 . 3 . . . . 1 . 1 .
 3 . . . . . . 1 . .
