 . . . . . . . 0 . .
 . 2 . . . . 0 0 0 .
 . 2 . S . . . 0 . .
 . 2 . . . . . . . .
 . . . . . . . . . .
 . . . . . . . . . .
 . . . . . . . 1 1 .
 . . 3 3 3 . . 1 1 .
 . 3 . . . . . . . .
 . . . . . . M . 4 4
