 . . 4 4 . . . . . .
 . . . . . . 1 . . .
 . . 2 . . 1 . 1 . .
 . 2 . . . . 1 . . .
 2 . . . . . . . . .
 . . . . 0 . . . . .
 . . S . 0 . . . . .
 . . . . 0 . . 3 . .
 . M . 0 . 0 . . 3 .
 . . . 0 . . . . . 3
