 . . . . . . . . . .
 1 . . . . 0 . . . 4
 1 1 1 1 . 0 . . . 4
 . . . . . 0 . . . .
 . . . . . 0 . . . M
 . . . . . 0 . . . .
 . . . S . . . . . .
 . . . . . . . . . .
 . . 2 2 2 . 3 3 3 .
 . . . . . . . . . .
