 . 3 3 3 . . . . . .
 . . . S . . . . . .
 . . . . . . . . . .
 . . 0 . . . . . . .
 . . 0 . . . . . . .
 . . 0 . . 1 1 1 1 .
 . . 0 . . . . . . .
 . . 0 . 4 . . . . .
 . . . . 4 . 2 2 2 2
 M . . . . . . . . .
