 . . . . . . . . . .
 S . . 0 . . . 1 1 .
 . . 0 0 0 . . 1 1 .
 . . . 0 . . . . 1 .
 . 3 . . . . . . . .
 . 3 . . . . . . . .
 . 3 . . . . M . . .
 . . . . . . . . . .
 2 2 2 . . . . . 4 4
 . . . . . . . . . .
