 . . . . . . 1 1 1 1
 . . . . . . . . . .
 . . . . . . . . . .
 . 0 0 0 0 0 . . 4 .
 . . 0 . . . . . 4 .
 . . . . . . . . . .
 . . . . . . S M . .
 . 2 2 2 . 3 . . . .
 . . . . . 3 . . . .
 . . . . . 3 . . . .
