 . . . . . . . 4 4 .
 1 1 . 3 3 3 . . . 4
 1 1 . . . . . M . .
 . . . . . . . . . .
 . . . . . . . . . .
 . . . . . 0 . . . .
 2 . . . 0 0 0 . . .
 2 . . . . 0 . . . .
 2 . S . . . . . . .
 . . . . . . . . . .
