 . . S . . . . . . .
 . 3 . 3 . . 2 . . .
 . . 3 . . 2 . . . .
 . 3 . . 2 . . . . .
 . . . . . . . . . .
 . M . 0 . . . . . .
 . . . . 0 0 0 . . .
 . . . 0 . . . . 1 .
 . . . . . . . 1 . 1
 . . 4 4 . . . . 1 .
