 . . . . 1 . . 2 2 2
 . . 1 1 . . . . . .
 . . 1 1 . M . . . .
 . . . . . . . . . .
 . . . . . . . 3 . .
 . . . . . . . 3 . .
 . 0 . . . . . 3 . .
 0 0 0 . . . . . . .
 S 0 . . . . . 4 . .
 . . . . . . . 4 . .
