 4 4 . . . . . . . .
 . S . . . 0 . . . .
 . . 0 0 0 . . . . .
 . . . 0 . 0 . . 2 .
 3 . . . . . . 2 . .
 . 3 . . . . 2 . . .
 . . 3 . . . . . . .
 M . . . 1 . . . . .
 . . . 1 . 1 . . . .
 . . . . 1 . . . . .
