 . . . S . . . . . .
 . . . . 4 . . . . .
 . . . . 4 . . . . .
 . . . . . . 3 . . .
 . 2 2 2 . . 3 . . .
 . . . . . . 3 . . .
 . . . . . . . . 0 .
 . . . . 0 0 0 0 0 .
 . . . . . . . . . .
 . . . . M . 1 1 1 1
