 . . . . . . . . . .
 . . 0 . . S . . . .
 . 0 0 0 . . . . M .
 . . 0 . . 3 . . . .
 . . . 0 . 3 . . . .
 . . . . . 3 . . . .
 . 1 1 . . . . . 2 .
 . 1 1 . . . . . 2 .
 . . . . . 4 4 . 2 .
 . . . . . . . . . .
