 . . . . . . . . . .
 . . 1 . . M . . 4 4
 . 1 . 1 . . . . . .
 1 . 1 . . . . . 3 .
 . . . . . . . 3 . .
 . . . . . . 3 . . .
 . . 0 . . . . . . .
 . . . 0 0 0 . . 2 .
 . . 0 . . . . 2 . S
 . . . . . . 2 . . .
