 . . . . . . 0 . . .
 . . . 0 0 0 . . . .
 . . . . . . 0 . . .
 . . . . . . . . 1 .
 . . . . . . . 1 . 1
 . 2 . . . . . . 1 .
 . . 2 . . . . . . .
 . . . 2 . 3 S 3 . .
 . . . . . . 3 . . M
 . . 4 4 . . . 3 . .
