 . . . . . . . . 0 .
 . . . . . . . . 0 0
 . . . . . . . . 0 .
 . . 3 3 3 . . . 0 .
 1 . . . . S . . 0 .
 1 . . . . . . . . .
 1 . 4 . . . M . 2 .
 1 . 4 . . . . . 2 .
 . . . . . . . . 2 .
 . . . . . . . . . .
