 . . . . . 2 . . . M
 . . . . 2 . . . . .
 S . . 2 . . . . . 0
 . . . . . . 0 0 0 .
 4 4 . . . . . . . 0
 . 4 . . 1 . . . . .
 . . . 1 . 1 . . 3 .
 . . . . 1 . . 3 . .
 . . . . . . 3 . . .
 . . . . . . . . . .
