 . . . . . . . . 1 1
 . . . 0 . . . . 1 1
 . . 0 0 0 . . . . .
 . . . 0 . . . . . .
 . . . . . . . . . .
 . . . . 3 . 2 2 2 .
 . . . 3 . . . . . .
 . . . 3 . . 4 . . .
 M . . 3 . . 4 S . .
 . . . . . . . . . .
