 3 3 3 . . . . . . .
 . . . . . . . . 4 4
 . . . . . . . . . .
 . . 1 . . . . . . .
 . . 1 1 1 1 . . . .
 . . . . . . . 2 . .
 0 0 0 0 0 . . 2 . .
 . . . . . . . 2 . .
 . . . . S . . . . .
 . . . . . M . . . .
