 2 . . . . . 1 . . .
 . 2 . . . 1 . . . .
 . . 2 . 1 . 1 . . .
 3 . . . . 1 . . . .
 . 3 . . . . . . . .
 . . 3 . . 0 . M . .
 . . . . . 0 . . . .
 . . . . . 0 . S . .
 . . 4 . 0 . 0 . . .
 . . 4 . . . . . . .
