 . 1 1 . . . . . . 3
 . 1 1 . . . 2 . . 3
 . . . . . . . 2 . 3
 . . S . . . . 2 . .
 . . . . . . . 2 . .
 M . . . . . . . . .
 . . . . . . . 4 . .
 . . . . 0 . . 4 . .
 . . . 0 0 0 . . . .
 . . . . 0 . . . . .
