 . . 0 . . . . . . .
 . . . 0 0 0 . . . .
 . . 0 . . . . . . .
 . . . . 4 4 . 3 . .
 . M . . 4 . . . 3 .
 . . . . . . . . . 3
 . 1 . . . . . . . .
 1 . 1 . . 2 . S . .
 . 1 . . . . 2 . . .
 . . . . . . . 2 . .
