 3 . . 0 . 0 . . . .
 . 3 . . 0 0 . . . .
 . . 3 . 0 . . . . 2
 . . . . 0 . . . 2 .
 . . . . . . . 2 . .
 . . . . . . . . . .
 . . . . . . . 1 . .
 . . . . . . 1 . 1 .
 . . M . 4 . . 1 . .
 . . . . 4 . . . S .
