 . . . . . . . . . .
 . . . . 0 . . 1 1 .
 . . . 0 0 0 . 1 1 .
 . S . . 0 . . . . .
 . . . . . . . 3 3 3
 . . . . . . . . . .
 . . . . . . . . . .
 2 2 . . . . . . M .
 . 2 . . . . 4 . . .
 . 2 . . . . 4 . . .
