 . . . . 4 . . . M .
 . . 3 . 4 . . . . .
 . 3 . . . . . . . .
 3 . . 0 . . . . . .
 . 3 . . 0 0 0 . . .
 . . . 0 . . . . . .
 . . S . . 2 . . . .
 . . . 1 . . 2 . . .
 . . 1 . 1 . . 2 . .
 . . . 1 . . . . . .
