 . . . . . . . . . .
 . . . . 1 . . . . .
 . . . . 1 . . 0 0 .
 . . . . 1 . . . 0 .
 . . . . 1 . . . 0 .
 . . . . . . 3 . 0 .
 . M . . . . 3 . 0 .
 . . . 2 . S 3 . . .
 . . . 2 . . . . . 4
 . . . 2 . . . . . 4
