 . . . . 0 . 0 . . .
 S . 1 . . 0 . . . .
 . 1 . 1 . 0 . . . .
 . . 1 . . 0 . . . .
 . . . . . . . . . .
 . . . . M . . . 2 .
 4 . 3 . . . . 2 . .
 4 . . 3 . . . . 2 .
 . . . . 3 . . . . 2
 . . . . . . . . . .
