 . 4 4 . . . . . . .
 . . . S . . . . . 2
 . . . . . . . . 2 .
 . . . 1 . . . 2 . .
 . . 1 . 1 . . . . .
 3 . . 1 . . . 0 . .
 . 3 . . . . . 0 . .
 . . 3 . 0 0 0 . . .
 . . . . . . . 0 . .
 . . . . . . . . . M
