 . . . . S . . . . .
 . . . . . . . . . .
 . . . . 0 . . . . .
 . . . 0 0 0 . 3 . M
 . . . . 0 . . 3 . .
 . . . . . . . 3 . .
 . . . . . . . . . .
 2 . . . . 1 . . . .
 2 . . 1 1 . . . . .
 2 . . 1 1 . 4 4 . .
