 . . 3 . . . . . . .
 . . 3 . . M . . . .
 . . 3 . . . . . . .
 1 . . 3 . . . . . .
 1 . . . . . . . . .
 1 . . . 0 0 0 0 0 .
 1 . . . . . . . . .
 . . . . . . . 4 S .
 . 2 2 2 . . . 4 . .
 . . . . . . . . . .
