 . . . 0 . . . . . .
 . . 0 0 0 . 3 3 3 .
 . . . 0 . . . . . .
 . . . . . . . . M .
 . . . . 4 . . . . .
 . . . . 4 . . . . 2
 . . . . . . 1 . . 2
 . . . . 1 1 . . . 2
 . . . . 1 1 . . . .
 . . . S . . . . . .
