 . . . . . . . . . .
 . 3 . . . . . . . .
 . 3 . . . S . . . .
 . 3 . . . . 0 . . M
 . . . . . . 0 . . .
 . . . . . 0 0 0 . .
 2 2 2 . . . 0 . . .
 . . . . . . . . . .
 4 4 . . . . 1 1 . .
 . . . . . . 1 1 . .
