 . . . . 4 . . . . .
 . 3 . . 4 . . . . .
 . 3 . . . . . . . .
 . 3 . . . . . 0 . .
 . . . . . . . 0 . .
 1 1 1 1 . . S 0 . .
 . . . . . 2 . 0 . .
 . . . . 2 . . 0 . .
 . . . . 2 . . . . .
 . . . . 2 . . . . M
