 . . 0 . . . 2 . . 4
 0 0 0 0 0 . 2 . . 4
 . . . . . . 2 . . .
 . S . . . . . . . .
 . . . . . . . . . .
 . . . . . . . 1 . .
 . . . M . . . 1 . .
 . . . . . . . 1 . .
 . . . 3 3 3 . 1 . .
 . . . . . . . . . .
