 . . . . . . . . . .
 . . . . . . . . . .
 4 4 . . . 1 1 1 1 .
 . . . . . . . . 1 .
 . . . . . . M . . .
 0 0 0 0 0 . . . . 3
 . . . . . . . . . 3
 S . . 2 2 2 . . . 3
 . . . . . . . . . .
 . . . . . . . . . .
