 . . . 3 . . . . . .
 . . 3 . . . . . . M
 . 3 . . . . . 2 . .
 . . . . . . 2 . . .
 . 1 . . . 2 . . . .
 1 . 1 . . . . . . .
 . 1 . . 0 . 0 . . .
 . . . S . 0 . . 4 .
 . . . . . 0 . . 4 4
 . . . . . 0 . . . .
