 . . . . . . 0 . . .
 . . . . . . . 0 0 0
 . . . . . . 0 . . .
 . . 1 . . 0 . . . 2
 . 1 . 1 . . . . 2 .
 . . 1 . . . . 2 . .
 . . . . . . S . . 3
 . . . . . . . . 3 .
 . M . 4 4 . . 3 . .
 . . . . . . . . . .
