 . . . . . . . . . .
 . . . 2 2 2 . . . .
 . . . . . . . . . 1
 . . . . . 0 . . . 1
 3 3 3 . . 0 . . . 1
 . . . . . 0 . . . 1
 . . . . . 0 . . . .
 . . . . . 0 . . S .
 4 . . . . . 0 . . .
 4 . . . . . . . M .
