 M . . . . 0 . . . .
 . . . . 0 0 0 . . .
 . . . . . 0 . . 1 1
 2 . . . . . . . 1 1
 2 . 3 3 3 . S . 1 .
 2 . . . . . . . . .
 . . . . . . . . . .
 . . . . . . . . . .
 . . . . . . . . . .
 . . . . . . 4 4 . .
