 . . . . . . . . . .
 . . . . . . . . . 2
 . . . . . . . . . 2
 . . 1 1 1 1 . . . 2
 . . 1 . . . . . . .
 . . . . . . 3 . . 0
 . . . . . . 3 . . 0
 . . 4 . . . 3 . . 0
 . . 4 . M S . . . 0
 . . . . . . . . . 0
