 . 1 . 1 . M . . . .
 1 . 1 . . . . . . .
 . 1 . . . . . . . .
 . . . . . . . . 2 .
 . . . . . . . 2 . .
 . . 0 . 0 . 2 . . .
 . . . 0 . . . . . .
 . . . 0 . . 3 . . .
 . . S 0 . . . 3 . .
 4 4 . . . . . . 3 .
