 . 4 4 . M . . . . .
 . . . . . . . 3 . .
 . . . . . . 3 . . .
 . . . 0 . 3 . . 1 S
 . . 0 . . . . 1 . 1
 . . . 0 0 0 . . 1 .
 . . 0 . . . . . . .
 . . . . 2 . . . . .
 . . . 2 . . . . . .
 . . 2 . . . . . . .
