 . . 2 . . . . . . .
 . . 2 . M . . . . .
 . . 2 . . . . 1 1 .
 . . . . . . . 1 1 .
 . S . . . . . . . 1
 . . . . . . . . . .
 . . . . 0 . . 3 . .
 . . . 0 0 0 . 3 . 4
 . . . . 0 . . 3 . 4
 . . . . . . . . . .
