 . . . . . 3 . . 1 .
 4 4 . . 3 . . 1 . 1
 . . . 3 . . . S 1 .
 . . . . . . . . . .
 . . . 0 . . . . . .
 . . . 0 . . . . . .
 . . . 0 . . . . . .
 . 0 0 . 0 . . 2 . .
 . . . . . . . . 2 .
 . . . . . M . . . 2
