 2 . . . . . . . . .
 2 . . . 4 . . . . .
 2 . 4 4 . . . . . .
 . . . . . . 3 3 3 .
 . 1 1 . . . . . . .
 . 1 1 . . . 0 . . .
 . . . . . 0 0 0 . .
 . . . . . . 0 . . .
 . . . . . . . . . .
 . . . . . S . . . M
