 . . M . . . . S . .
 . . . . 0 . . . . .
 . . . 0 0 0 . . 4 .
 . . . . 0 . . . 4 4
 . . . . . . . . . .
 3 3 3 . . 1 1 . . .
 . . . . . 1 1 . . .
 . . . . . . . . . .
 . . . . . . . . . .
 . . . . . 2 2 2 . .
