 . . . . . 2 2 . . .
 . . 4 4 . . . 2 . .
 . . . . . . . . 2 .
 . . . 1 . . . . . .
 . . 1 . 1 . . . . .
 . . . 1 . . . . . 0
 . . . . . . 0 0 0 .
 M . . . 3 . . . . 0
 . . . 3 . . . . . .
 . . 3 . S . . . . .
