 4 4 . . . . . . . .
 . . . . S . . . . .
 . 0 . . . . . . 3 .
 . . 0 0 0 . . 3 . .
 . 0 . . . . 3 . . .
 . . . . . . . . . .
 . . . . . . . . 2 .
 . 1 . 1 . . . 2 . .
 . . 1 . 1 . 2 . . M
 . . . 1 . . . . . .
