 . . . . . . . . . .
 . . . . . . . . . .
 0 . . . . 1 1 1 1 S
 0 . . . . . . 1 . .
 0 . . . . . . . . .
 0 . . . . . . . . .
 0 . 3 3 3 . 2 . . .
 . . . . . . 2 . . .
 . . . . . . 2 . . .
 M . 4 4 . . . . . .
