 . . . . . . . . . .
 . . 2 . . . . . . .
 . 2 . . 0 . 3 . . .
 2 . . . 0 . 3 . . .
 . . . . 0 . . 3 . .
 . . . 0 . 0 . . 3 .
 . . . . . . . . . .
 M . . S . . . . 1 .
 . . . . . 4 . 1 . 1
 . . . . . 4 . . 1 .
