 . 3 3 3 . . 0 . M .
 . . . . . . 0 . . .
 . . 1 . . . 0 . . .
 . . 1 . . . 0 . . .
 . . 1 . . . 0 . . .
 . . 1 . . . . . . .
 . . . . 2 2 2 . . .
 . . . . . . . S . .
 . 4 4 4 . . . . . .
 . . . . . . . . . .
