 3 3 3 3 . . 2 2 2 .
 . . . . . . S . . .
 . . . . . . 4 4 . .
 . M . . . . . . . .
 . . . . . . 1 1 1 1
 . . . . 0 . . . . .
 . . . . 0 . . . . .
 . . . . 0 . . . . .
 . . . . 0 . . . . .
 . . . . 0 . . . . .
