 . . . . . 0 . . . .
 . . . . 0 0 0 . . .
 . . . . . 0 . . . .
 . . . . . . . 4 4 4
 . . 3 3 3 . . . . .
 . . . . . . . . . .
 . 1 1 . . . . . . S
 . 1 1 . . . . . . .
 . . . . . . . M . .
 . . . 2 2 2 . . . .
