 . . 3 . . . . . . .
 . 3 . . . . . . . .
 3 . . . . . 0 . . .
 . 3 . 0 0 0 . . . .
 . . . . . . 0 . . .
 . . . . . . . . . 4
 2 . . . . 1 . . . 4
 . 2 . . 1 . 1 . . .
 . . 2 . . 1 . . . .
 S . . . . . . . . M
