 . . . . . . . . . .
 . M . . . . 2 . 2 .
 . S . . . . . 2 . .
 . 0 . . . . 2 . . 3
 . . 0 0 0 . . . 3 .
 . 0 . . . . . 3 . .
 . . . . . . . . . .
 . . . 4 . . 1 . . .
 . . . 4 . 1 . 1 . .
 . . . . . . 1 . . .
