 . . . M . . . . . .
 . . . . . . . . . .
 . . . 3 . . . . 0 .
 . . . 3 . . . 0 0 0
 . S . 3 . . . . 0 .
 . 4 . . . . . . . .
 . 4 . . . 1 1 . . .
 . . . . . 1 1 . . .
 . . . . . . . . . .
 . . . . . 2 2 2 2 .
