 . . . . . . . M . .
 . 0 . . . . . . . .
 . . 0 0 0 0 0 . . .
 . . . . . . . . 1 .
 . . . . . . 4 . 1 .
 . . . . . . 4 . 1 .
 . . 2 . . . . . 1 .
 . . 2 . . 3 . . . .
 . . 2 . . 3 . . . .
 . S . . . 3 . . . .
