 . . . . . . . . . .
 . 2 . . . . . . . .
 . . 2 . . 0 . 0 . .
 . 2 . 2 S . 0 . . .
 . . . . . . 0 . . .
 . M . . . . 0 . . 4
 . . . 1 . . . . . 4
 . . 1 . 1 . . 3 . .
 . . . 1 . . . . 3 .
 . . . . . . . . . 3
