 . . . . . M . . . .
 . . . 1 . . . . 0 .
 . . 1 . 1 . . . 0 .
 . . . 1 . . . . 0 .
 . . . . . . . 0 . 0
 . S . . . . . . . .
 . . 3 . . . . 2 . .
 . . 3 . . . 2 . . .
 . 3 . . . 2 . . . 4
 3 . . . . . . . . 4
