 . . . . 2 . . . . .
 . . . 2 . . 1 . . .
 . . 2 . . . 1 . . .
 . . . . . 1 . 1 . .
 . . . . . . 1 . . .
 4 4 . . . . . S . .
 . . . 3 . . . M . .
 . . 3 . . 0 . . . .
 . 3 . . . . 0 0 0 .
 . . . . . 0 . . . .
