 . . . . . . . . M .
 . . . . . . . . . .
 . 1 1 . . . . . . 2
 . 1 1 . . . . . 2 2
 . . . . . . . . . 2
 . . . . 0 . S . . .
 . . . 0 0 0 . . . .
 . 3 . . 0 . . . . .
 . 3 . . . . . 4 . .
 . 3 . . . . . 4 . .
