 . . 1 . . . . . . .
 . 1 . 1 . . . . . 0
 . . 1 . . . 0 0 0 .
 . . . . . . . . . 0
 S . . . . . . 2 . 0
 . . . . . . 2 . . .
 . . . . . 2 . . . .
 . . . . . . . . . 3
 . 4 . . . . . . 3 .
 . 4 . M . . . 3 . .
