 . . . . 2 2 2 . 1 1
 . . S . . . . . 1 1
 . . . . . . . . . .
 . . 3 3 3 . . . . .
 . 3 . . . . . . 4 4
 . . . . . . 0 . . .
 . . . . . 0 0 0 . .
 . . . . . . 0 . . .
 . . . . . . . . . .
 . . . M . . . . . .
