 . . . . . . 4 4 . .
 2 2 2 2 . . . . . .
 . . . . . . . . . 0
 M . . . . . . . S 0
 . . . . . . . . . 0
 . . . 3 . . . . . 0
 1 . . 3 . . . . . 0
 1 . . 3 . . . . . .
 1 . . . . . . . . .
 1 . . . . . . . . .
