 . . . . . . . . . 2
 . . 0 . . . . . . 2
 . 0 0 0 . . . . 2 2
 . . 0 . . . . . . .
 . . . . . . 3 . . .
 . . . . . . 3 . 4 4
 . . . . . . 3 . . .
 . . 1 1 . . . . . .
 S . 1 1 . . . . . .
 . . . . . . M . . .
