 . . . . . . . . 3 .
 . 1 . . . . S . 3 .
 . 1 . 2 . . . 3 3 .
 . 1 . 2 . . . . . .
 . 1 . 2 . 0 . . 4 4
 . . . . . 0 . . . .
 . . . . . 0 . . . .
 . . . . . 0 . . . .
 . . . . . 0 . . . .
 . . M . . . . . . .
