 . . . . . . . . . .
 1 1 . . . . . . . .
 1 1 . 4 . . . . . .
 . . . 4 . 2 2 2 . .
 . . . . . . . . . .
 . . . . . . . . . .
 . . . 0 . . . . . .
 . . 0 0 0 . . . . .
 . . 0 0 . . . . . .
 M . . . S . 3 3 3 .
