 . . . . . . . M . .
 . 2 2 2 . . . . . .
 . . . . . . . . . .
 . 4 . . . . 0 . . .
 . 4 . . . 0 0 0 . 3
 . . . . . . 0 . . 3
 . S . . . 0 . . . 3
 . . 1 1 . . . . . .
 . . 1 1 . . . . . .
 . . . . . . . . . .
