 . . . . . . S . . .
 . . . . . . . . . .
 . . . . . . . 4 4 .
 M . . . . . . . . .
 . . 3 . . . . . . .
 . . 3 . 0 0 0 0 0 .
 1 . 3 . . . . . . .
 1 . 3 . . . 2 2 2 .
 1 . . . . . . . . .
 1 . . . . . . . . .
