 . . S . 1 . . . . .
 . . . 1 . 1 . . 4 4
 . . . . 1 . . . . .
 . . . . . . . 2 . .
 . . . . . . . . 2 .
 . . . . . . 3 . . 2
 0 . 0 . . . . 3 . .
 . 0 0 0 . . . . 3 .
 0 . . . . . . . . .
 . . . . . . . . . M
