 . . . . . . . . 4 .
 . . . . . . . . . 4
 M . . . . . . . . 4
 . . S 0 . . 2 . . .
 0 0 0 . . . . 2 . .
 . . . 0 . . . . 2 .
 . . . . . . . . . .
 3 . . . . . 1 . . .
 . 3 . . . 1 . 1 . .
 . . 3 . . . 1 . . .
