 . . . 4 . . . . . .
 . 3 . 4 . . . . . .
 . 3 . 4 . S . . . .
 . 3 . . . . M . 1 1
 . . . . 0 . . . 1 1
 . . . 0 0 0 . . . .
 . . . . 0 . . . . .
 . . . . . . . . . .
 . . . . . . . . . .
 . . . . . . . 2 2 2
