 . . . . . . 4 . 1 .
 . . . . . . 4 . 1 .
 . . . . . . . . 1 .
 M S . 0 . . . . 1 .
 . . . 0 . . . . . .
 . . . 0 . . . . . .
 . . . 0 . . . 2 . .
 . . . 0 . 3 . . 2 .
 . . . . . 3 . . 2 .
 . . . . . 3 . . 2 .
