 . . . . . . . . . .
 . . . 2 . 4 4 4 . .
 . . 2 . . . . . . .
 . 2 . . . 0 . 0 . .
 . . . . . . 0 . . .
 . . . . . . 0 . . .
 . . 1 . . . 0 . . 3
 . 1 . 1 . . . . 3 .
 . . 1 . . . . 3 . .
 M . S . . . . . . .
