 . . . . . . . . . .
 . 2 . . . . 1 1 . .
 . 2 . . . . 1 1 . .
 . 2 . . . . . . . .
 . . . . . . 0 . . .
 . . . . . 0 0 0 . .
 . S . . . . 0 . 0 .
 . . . . . . . . . .
 . 4 . . . 3 3 3 . .
 . 4 . M . . . . . .
