 4 . . . . . . . . .
 . 4 4 . . . . . . M
 . . . . . . . . . .
 . . . . 0 . . . . 2
 . . . 0 0 0 . 3 . 2
 . . . . 0 . . 3 . 2
 . . . . . . . 3 . .
 . . . . . . . . . S
 1 1 . . . . . . . .
 1 1 . . . . . . . .
