 4 4 S . . . . . . .
 . . . . . . . . . .
 . . . . . . 2 . . .
 . . . . . . 2 . . .
 . 0 . . . . 2 . 3 .
 0 0 0 . . . . . 3 .
 . 0 . . . . . . 3 .
 . . . M . . . . . .
 . . . . . 1 1 1 . .
 . . . . . 1 1 . . .
