 . . . . . . . . . .
 4 . . . . . . . . .
 4 . . . . . . . . .
 . . . . . . . . S 2
 . . . . . . . . . 2
 . 0 . . . . . . . 2
 0 0 0 0 0 . . . . .
 . . . . . . . . . .
 3 3 3 . 1 1 1 1 . M
 . . . . . . . . . .
