 M . . . . . . 3 . .
 . . 0 . . . 3 . . .
 . . 0 . . 3 . . 2 .
 . . 0 . . . . 2 . .
 S 0 . 0 . . 2 . . .
 . . . . . . . . . .
 . . 1 . 1 . . . . 4
 . . . 1 . 1 . . . 4
 . . . . 1 . . . . .
 . . . . . . . . . .
