 . . . . . . . . . 3
 . . . 1 1 1 1 . . 3
 . . . 1 . . . . . 3
 . . . . . . . . . .
 S . . . . . . 2 2 2
 4 4 . . 0 . . . . .
 . . . . 0 . . . . .
 . . . . 0 . . M . .
 . . . . 0 . . . . .
 . . . . 0 . . . . .
