 . . . . . . . 4 . .
 . . . 3 3 . . 4 . .
 . . . 3 . . . . . .
 . . . 3 . . . . . .
 . . . . . . . . . .
 . . M . . . . . . .
 . . . . . . . . . .
 . . . . . . 0 . S 2
 . . 1 1 . 0 0 0 . 2
 . . 1 1 . . 0 . . 2
