 . . . . . . . . . .
 . . 0 . 0 . . . 3 .
 . . . 0 . . . 3 . .
 . . . 0 . . 3 . . .
 2 . . 0 0 . . . . 4
 . 2 . . . . . . . 4
 . . 2 . M . . . . .
 . . . S . . 1 . . .
 . . . . . 1 . 1 . .
 . . . . . . 1 . . .
