 . . . . . . . . . .
 . . . . . . . . . .
 . . . . . . . . . .
 . . . 0 0 0 0 0 . .
 . . . . . . . . . .
 . . . . . . . M . .
 . . 2 2 2 . . S . .
 . . . . . . 1 1 1 1
 4 4 . . . . . . . .
 . . . 3 3 3 3 . . .
