 . . . . 0 . . . . .
 . 3 . . 0 . . . . .
 . 3 . . 0 . S . . .
 . 3 . . 0 . 4 4 4 .
 . . . . 0 . . . . .
 . . . . . . . . . .
 . . . 1 1 1 1 . . M
 . . . . . . . . . .
 . . 2 2 2 . . . . .
 . . . . . . . . . .
