 . . S . . . . . . .
 . . . . 1 . . . . .
 . 0 . 1 . 1 . . 4 .
 . 0 . . 1 . . . 4 .
 . 0 . . . . . . . .
 0 . 0 . . . . . . .
 . . . . 3 . 2 . . .
 . . . 3 . . . 2 2 .
 . . 3 . . . . . 2 .
 . . . . M . . . . .
