 . . . . . 1 . . . M
 . 3 . . 1 . 1 . . .
 . . 3 . . 1 . . . .
 . . . 3 . . . . . .
 . . . . . . . . . .
 S 4 4 . . . . 0 . .
 . . . . . . . 0 . .
 . . 2 . . 0 . 0 . .
 . . . 2 . . 0 . 0 .
 . . . . 2 . . . . .
