 . . M . . . 3 . . .
 . . . . . . . 3 . .
 . . . . . . . . 3 .
 . . 0 . 0 . S . . .
 . . . 0 . . . . . .
 . . . 0 . . . . . .
 . . . 0 . . 2 . . .
 . . . . . 2 . . 1 .
 4 4 4 . 2 . . 1 . 1
 . . . . . . . . 1 .
