 . . . 0 . . . . . .
 . . . 0 . . . . . .
 . . 0 0 0 . . . 4 4
 2 . . 0 . . . . . .
 2 . . . . . . S . .
 2 . . . . . . . M .
 . . 3 . . . . . . .
 . . 3 . . 1 1 . . .
 . . 3 . . 1 1 . . .
 . . . . . . . . . .
