 . . . . . . . . . .
 4 . 3 3 3 . . . . .
 4 S . . . . . . . .
 . . . 1 1 . . . . .
 . . . 1 1 . . . . .
 . . . . . . M . . .
 . . . 0 . . . . . .
 . . 0 0 0 . . 2 2 2
 . . . 0 . . . . . .
 . . . 0 . . . . . .
