 . . . M . . 3 . . .
 . . . . . . . 3 . .
 . . . 0 . . . . 3 .
 4 . . . 0 0 0 . . .
 4 . . 0 . . . . . .
 . . . . . . . . . .
 . . . 2 . . S . . .
 . . 2 . . . . 1 . .
 . 2 . . . . 1 . 1 .
 . 2 . . . . . 1 . .
