 . . . . . . . . . .
 . . . . . . 1 1 1 1
 . . . . . . . . . .
 . . . . . . . . . .
 . . . 4 . . . . . .
 . . . . 4 . . . . .
 . 2 . . 4 . . 3 3 3
 . 2 . . . . . . . S
 . 2 . . . . . . . .
 . . . 0 0 0 0 0 . M
