 . . S . . . . . . .
 . . . 1 1 1 1 . . .
 . . . . . . . . . .
 . . . . 4 4 . . . .
 . . . 4 . . . . . .
 0 . . . . . . . . M
 0 . . . . . . . . .
 0 . . 3 . . . . . 2
 0 . . 3 . . . . . 2
 0 . . 3 . . . . . 2
