 . . . . . . . . . .
 . . . . . . . 1 . .
 0 . . . . . 1 . 1 .
 . 0 0 0 . . . 1 . 1
 0 . . . . . . . . .
 . . . . 4 4 . . . .
 . . . . . . . . 2 .
 3 . . . . . . 2 . .
 . 3 . S . . 2 . . .
 . . 3 . . . . . . M
