 . . . . . . . . . S
 . . . . 2 . . . M .
 . 1 1 . 2 2 2 . . .
 . 1 1 . . . . . . .
 . . . . . . . . . .
 . 4 . . . . . . 0 .
 . 4 . . . . . 0 0 0
 . . . . . 3 . . 0 .
 . . . . . 3 . . . .
 . . . . . 3 . . . .
