 1 1 . . . 0 . . . .
 1 1 . S 0 0 0 0 . .
 . . . . . 0 . . . .
 . . . . . . . . . .
 . . . . . . . . . .
 . . 2 2 2 . . . . .
 . . . . . . . . . .
 . . . . . . . 3 3 3
 . M . . 4 . . . . .
 . . . . 4 . . . . .
