 . . . . . . . . . .
 . . . 0 . . 4 . . .
 . . 0 0 0 . 4 . . .
 3 . . 0 . . . . . .
 3 . . . . . . . . .
 3 . . S . . . . . .
 . . 2 . . 1 1 . . M
 . . 2 . . 1 1 . . .
 . . 2 . . . . . . .
 . . 2 . . . . . . .
