 . . . . . . . . . .
 . . . . 3 3 3 . 0 .
 . . S . . . . . 0 .
 . . . . . . . . 0 .
 1 . 4 4 . . . . 0 .
 1 . . . . . . . 0 .
 1 . . . . . . . . .
 1 . . 2 2 2 2 . . .
 . . . . . . . . . .
 . . . . M . . . . .
