 0 0 0 0 0 0 . . . .
 . . . . . . . . . 1
 . 4 4 . . . . . . 1
 . . . . . 2 . . . 1
 . . . . . 2 . . . 1
 . . . M S 2 . . . .
 . . . . . . . 3 3 3
 . . . . . . . . . .
 . . . . . . . . . .
 . . . . . . . . . .
