 . . . . . . . . . 1
 . M . . . 1 1 1 1 .
 . . . . . . . . . .
 . . . . . . . . . .
 . . . . . 0 . S 3 .
 . . . . . 0 . . 3 .
 . . . . . 0 . . 3 .
 . . . . . 0 . . . .
 . 4 . . . 0 . . . .
 . 4 . . . . . 2 2 2
