 . . . . . . . . . 4
 . 3 3 3 . . . 4 4 .
 . . . . . . . . . .
 2 . . . . . . . . .
 2 . . . . . . S . .
 2 . . . . . 1 . 0 .
 . . . . . . 1 . 0 .
 . . . . . . 1 . 0 .
 . . . . . . 1 . 0 .
 . . . . M . . . 0 .
