 . . . . . . . . . .
 . . . . . . . . . .
 . . . 0 . . . 3 . .
 0 0 0 . . . 3 . S .
 . . . 0 . 3 . . 1 .
 . . . . . . . 1 . 1
 . . 4 . . . . . 1 .
 . . 4 . . 2 . . . .
 . . . . 2 . . . . M
 . . . 2 2 . . . . .
