 . . . . 3 . . . . .
 . . . . 3 . . . . .
 . . . . 3 . . . S 4
 . . 0 . . . . . . 4
 . 0 0 0 . . . . . .
 . . 0 . . . . . . .
 . . 0 . . . . . . .
 . . . . . . . . . .
 . 1 1 . M . . . . .
 . 1 1 . . . . 2 2 2
