 . . 3 . . . . . . .
 . . 3 . . . . . 1 1
 . . 3 . . . . . 1 1
 . . . . . . . . . .
 . . . . 0 . . . . .
 . . . 0 0 0 . . . .
 . . . . 0 . . 4 4 .
 . . . . . . . . . .
 . . . . . 2 . . . S
 . . . M . . 2 2 2 .
