 . . . . . . 3 3 3 .
 . . . . . . . . . .
 . . 1 1 . . . . . M
 . . 1 1 . . . . . .
 . . . . . . . . . .
 . 0 . . . . . . 2 2
 0 0 0 . . . . . . 2
 . 0 . . . . . . . 2
 . . . . . 4 . . . .
 . . . . . 4 . S . .
