 . . . . . . . . . .
 . . . . . . . . . .
 . . . . 2 2 2 . 1 1
 . . . . . . . . 1 1
 . 0 . . M . . . . .
 0 0 0 . . . . . . S
 . 0 . . . . . . . .
 . . . 3 . . . 4 . .
 . . . 3 . . 4 4 . .
 . . . 3 . . . . . .
