 . . . M . . . . . .
 . . . . . S . . 4 4
 . 1 1 1 1 . . . . .
 . . . . . . . . . .
 . . . . . . . . . .
 . 0 0 0 0 0 . . . .
 . . . . . . . . . .
 . . . . . 2 . . . 3
 . . . . . 2 . . . 3
 . . . . . 2 . . 3 3
