 . . . . . . 3 3 3 .
 . . . 1 1 . . . . .
 . . . 1 1 . . . M .
 . . . . . 1 . . . .
 . . . . . . . . . .
 . . . . 2 . . 0 . .
 . . . . 2 . 0 0 0 .
 . . . . 2 . . 0 . .
 . . . . . . . . . .
 . 4 4 . . S . . . .
