 . 0 . . . 1 1 1 1 .
 . . 0 . . . . . . .
 . . 0 . . . M . . .
 . S 0 . . . . . . .
 . . 0 . . . . . . .
 . . 0 . 3 3 3 . . .
 . . . . . . . . 2 .
 . . . . . . . . 2 .
 . . 4 4 . . . . 2 .
 . . . . . . . . . .
