 . . . . . . . . . .
 3 . . . . . . . . .
 3 . . . . . M . . .
 3 . 1 1 . . . . 2 .
 . . 1 1 . . . . 2 .
 . . . . . . . . 2 .
 . . . . . . . S . .
 . 4 . . . . . . 0 .
 . 4 4 . . . . 0 0 0
 . . . . . . . . 0 .
