 . . . . . . . . . .
 . 3 . . . . . . . 4
 . 3 . . . . . . . 4
 . 3 . 0 . . . . . .
 . . . 0 . . . . . .
 . . . 0 . . 1 1 1 1
 2 . . 0 . . . . . .
 2 . . 0 . . . . . .
 2 . . 0 . S . . . .
 . . . . . . . M . .
