 . . . . . . . . . .
 . . . . . . M . . .
 . . 0 . . . . . . .
 . 0 0 0 . . . 4 . .
 . . 0 . . . . 4 . .
 . . . . . . . . . .
 S . . . 2 2 2 . . .
 . 3 . . . . . . . .
 . . 3 3 3 . . 1 1 .
 . . . . . . . 1 1 .
