 . . . . 3 3 3 . . .
 . . 2 . . . . . 1 1
 . . 2 . . . . . 1 1
 . . 2 . . . . . . S
 . . . . . . . M . .
 . . . . . . . . . .
 . . . . . . . . . .
 . . . . 0 . . . 4 4
 . . . 0 0 0 . . . .
 . . . 0 0 . . . . .
