 . . . . . . . 3 . .
 . 1 1 1 1 . . 3 . .
 . . . . . . . 3 . .
 4 . . . . . . . . .
 4 . . . . . . . . .
 . . . . . . . . 0 .
 . . . . . . . . 0 S
 . . . . . . . . 0 .
 2 2 2 . . . . . 0 .
 . . . . M . . . 0 0
