 . . . . . . . 0 . .
 . 4 . . 0 0 0 . . .
 . 4 . . . . . 0 . .
 4 . . . . . . . . .
 . . . . . . . . . .
 . . . . 3 . . . . M
 . . 1 . . 3 S . . .
 . 1 . 1 . . 3 . . 2
 . . 1 . . . . . 2 .
 . . . . . . . 2 . .
