 . . . . . . . . . 0
 . . . . 3 . 0 0 0 .
 . . . 3 . . . . . 0
 . . 3 S . . . . . .
 . . . . . . . . . M
 . . . . 2 . . . . .
 . 2 . 2 . . . . 1 .
 . . 2 . . . . 1 . 1
 . . . . 4 . . . 1 .
 . . . . 4 . . . . .
