 . 1 . . . . . . . .
 1 . 1 . . . . . M .
 . 1 . S . . 0 . . .
 . . . 3 . . 0 . . .
 . . 3 . . . 0 . . .
 . 3 . . . . 0 . . .
 . . . . . 0 . 0 . .
 . . 2 . . . . . . .
 . . . 2 . . . . . .
 4 4 . . 2 . . . . .
