 . . . M . . . . 3 .
 . . . . . . . . 3 .
 . . 1 1 1 1 . . 3 .
 . . . . . . . . . .
 . . . . . . . . . .
 . . . . . 0 0 0 0 0
 . . . . . . . . . .
 . . S . . . . . . .
 . 4 4 . 2 2 2 . . .
 . . . . . . 2 . . .
