 . . . . 1 1 1 1 . .
 . . . . . . . . 1 .
 2 . . 3 3 3 . . . .
 2 . S . . . . . . .
 2 . . . . . . . . .
 . . . 4 4 . . 0 . .
 . . . . . . . 0 . .
 . . . . . . . 0 . .
 . . . . . . . 0 . .
 M . . . . . . 0 . .
