 . . . M . . . . . .
 . . . . . . . . . .
 . . . 2 . . 0 . 0 .
 . . . . 2 . . 0 . .
 S . . . . 2 . 0 . .
 . . 4 . . . . 0 . .
 4 4 . . 1 . . . . .
 . . . 1 . 1 . . . 3
 . . . . 1 . . . 3 .
 . . . . . . . 3 . .
