 . . . . . . . . 4 .
 . . . . 1 . . . 4 .
 . . . 1 . 1 . S . .
 3 . . . 1 . . . . .
 . 3 . . . . . . . .
 . . 3 . . . 0 . . .
 . . . . M . . 0 0 0
 . . 2 . . . 0 . . .
 . 2 . 2 . . . . . .
 2 . . . . . . . . .
