 . . . . . . . 2 . .
 . . 1 1 . S . 2 . .
 . . 1 1 . . . 2 . .
 . . . . . . . . . .
 . . . . . . . . . .
 . . . . . . 0 . 0 .
 . . M . . . . 0 0 0
 . . . . . . . . 0 .
 . . . . . . 4 . . .
 3 3 3 . . . 4 . . .
