 . . . . . . . . . .
 . 2 . . . . . 1 . S
 . 2 . . . . . 1 . .
 . 2 . . . 3 . 1 1 .
 . . . . . 3 . 1 . .
 . . . . . 3 . . . .
 . . 4 4 . . . M . .
 . . . . . . . . . .
 . . . 0 0 0 0 0 . .
 . . . . . . . . . .
