 . 0 . . . . . . . .
 0 0 0 . . . 3 3 3 .
 . 0 . . . S . . . .
 . . . . . . . . . M
 . . . . . 1 1 . . .
 . . . . . 1 1 . . .
 . . . 2 . . . . . 4
 . . . 2 . . . . . 4
 . . . 2 . . . . 4 .
 . . . . . . . . . .
