 . . . . . . . . . .
 . 2 2 2 . 0 . 3 . .
 . . . . . 0 . 3 . M
 . . . . . 0 . 3 . .
 . . . . . 0 . . . .
 . . . . S 0 . . . .
 . . . . . . . . 1 .
 . . . . 1 1 1 1 . .
 . . . . . . . . . .
 . . . 4 4 . . . . .
