 . . . . 3 3 3 . . .
 . . . . . . . . . .
 . . . 0 . . . 1 1 .
 . . 0 0 0 . . 1 1 .
 . . . 0 . . . . . .
 . . . . . . . . . S
 M . . . . . . . . .
 . . . . 2 2 2 . . .
 . 4 . . 2 . . . . .
 . 4 . . . . . . . .
