 S . . . . . 2 2 2 .
 . . M . . . . . . .
 . . . . . . . . . .
 . . . . 1 1 . . . .
 . 4 . . 1 1 . . 0 .
 . 4 . . . . . 0 0 0
 . . . . . . . . 0 .
 . . . 3 . . . 0 . .
 . . . 3 . . . . . .
 . . . 3 . . . . . .
