 . . . . . . . . . .
 . 4 4 . . 2 . . . .
 S . . . . . 2 . . .
 . 0 . . . . . 2 . .
 . . 0 0 0 . . . . .
 . 0 . . . . . . 1 .
 . . . 3 . . . 1 . 1
 . . . . 3 . . . 1 .
 . . M . . 3 3 . . .
 . . . . . . . . . .
