 . . . . . . . . . .
 . . . . 0 . . . 2 .
 . . . 0 0 0 . . 2 .
 . M . . 0 . . . 2 .
 . . . . . . . . . .
 . . . 4 . . . 3 . .
 1 1 . 4 . . . . 3 .
 1 1 . . . . . S 3 .
 . . . . . . . . 3 .
 . . . . . . . . . .
