 . . . . . . . . . .
 . M . . . . . . . .
 . . . . 0 0 0 0 0 .
 . . 2 . . . . . . .
 . . 2 . . 1 . . . .
 . . 2 . . 1 . . . .
 . . . . . 1 . 4 4 .
 3 3 . . . 1 . . S .
 . 3 . . . . . . . .
 . 3 . . . . . . . .
