 . . 2 . . . . M . .
 . 2 . . . . . . . .
 2 . . . . . . . . .
 . . . . . . . 1 . .
 . . 0 . . . 1 . 1 .
 . . 0 . 4 . . 1 . .
 . S 0 . . 4 . . . 3
 . 0 . 0 . 4 . . 3 .
 . . . . . . . 3 . .
 . . . . . . . . . .
