 . . . . 1 S . . . .
 . . . . 1 . . M . .
 . . . . 1 . . . . .
 . . . . 1 . . . . .
 . . 0 . . . . . 3 .
 . . 0 . 2 2 2 . 3 .
 . . 0 . . . 2 . 3 .
 . . 0 . 4 . . . . .
 . . 0 . 4 . . . . .
 . . . . . . . . . .
