 . . . . . . . . . .
 . . . . 0 0 0 0 0 .
 . . . . . . . . . .
 . . . . M . . . . 1
 2 2 2 . . . . . . 1
 . . . . . . . . . 1
 . . . . . . . . . 1
 . . 3 . . . . S . .
 . . 3 3 3 . 4 . . .
 . . . . . . 4 . . .
