 . . . . 0 . . . . .
 . . . . 0 . . 3 . .
 . 0 0 0 . . . . 3 .
 . . . . 0 . . . . 3
 . . . . . . . . . .
 . . . . 4 4 . . . .
 . 2 . . . . . . 1 .
 . . 2 . . . . 1 . 1
 M . . 2 . . . . 1 .
 . . . . . . . . S .
