 S 4 . . . . . . . .
 4 4 . . . 3 3 3 . .
 . . . . . . . . . .
 . . . . . . 1 1 . .
 . . . . . . 1 1 . .
 . . 2 2 2 . . . . .
 . . . . . . . . . .
 . 0 . . . . . . M .
 0 0 0 . . . . . . .
 . 0 . . . . . . . .
