 . . . . 1 . . . . .
 . . . . 1 1 1 1 . .
 . . . . . . . . . .
 2 . . . . . M . . 3
 2 . 0 . . . . . . 3
 2 . 0 . . . . . . 3
 . . 0 . 4 4 . . . .
 . . 0 . . . . . S .
 . . 0 . . . . . . .
 . . . . . . . . . .
