 . . . . 3 . . . . .
 . . . . 3 . . . . .
 S . M . 3 . . . . .
 . . . . . . 2 2 2 .
 . . . . . . . . . .
 . . . . . 4 4 . . .
 . . . . . . . . . .
 1 1 1 1 . . . . . .
 . . 1 . . 0 0 0 0 0
 . . . . . . . . . .
