 . . . . 0 0 0 0 0 .
 . 3 . . . . . . . .
 . 3 . . . . . . . .
 . 3 . . 1 . . . . .
 3 . . . 1 . . . . .
 . . S . 1 . . 2 2 2
 . . . . 1 . . . . .
 . . . . . . . . . M
 . 4 4 . . . . . . .
 . . . . . . . . . .
