 . . . S . . . . . 0
 . . . . . 1 . . . 0
 . . . . . 1 . . . 0
 2 . . . . 1 . . . 0
 2 . . . . 1 . . 0 0
 2 . 3 . . . . . . .
 . . 3 . . . . . . .
 M . 3 . . . . . . .
 . . . . . . . . . .
 . 4 4 . . . . . . .
