 . . . . . . . . . .
 . . . 4 4 . . . M .
 . . . . . . . . . .
 . 3 . . . . . . . .
 . 3 . 1 1 1 1 . . .
 . 3 . . . . . . . .
 . . . . . . S . . .
 0 0 0 0 0 0 . 2 . .
 . . . . . . . 2 . .
 . . . . . . . 2 . .
