 2 . . . . . . . . .
 2 S . 3 3 3 3 . . .
 2 . . . . . . . . .
 . . . . . . . . . .
 . . . . . . . . . .
 . . . . . . . . . M
 . . . . . 1 1 . . .
 . . 0 . . 1 1 . . .
 . 0 0 0 . . . . . .
 . . 0 . . . 4 4 . .
