 . . . S . . . . 0 .
 2 . . . . . . 0 0 0
 2 . . . . 4 . . 0 .
 2 . 1 1 . 4 . . . .
 . . 1 1 . . . . . .
 . . . . . M . . . .
 . . . . . . . . . .
 . . . . . . . . . .
 . . 3 . . . . . . .
 . . 3 3 3 . . . . .
