 . . . . . . . . 2 .
 . . M . . . . 2 . .
 . . . . . . 2 2 . .
 . 1 . . . . . . . .
 1 . 1 . . . . . . .
 . 1 . . . . . 0 . .
 . . . 4 4 . . 0 . .
 . 3 . . . . . 0 . .
 . . 3 . S . 0 . 0 .
 . . . 3 . . . . . .
