 . . . . . 2 2 2 . .
 . . . . . . . . . .
 . . 0 . . . . . . .
 . 0 0 0 . . . . . .
 . . 0 . . . . . . .
 . . . . . . . 4 4 4
 . . . . . . . . . .
 . . . M . . 3 . . .
 1 1 . . . . 3 . . .
 1 1 . . . . 3 . S .
