 . . . . . . 0 . . .
 1 1 . . . 0 0 0 . .
 1 1 . . . . 0 . . .
 . . . . . . . . . .
 . . . M . . 3 3 3 .
 . . . . . . . . . 3
 . . . . . . . . . .
 . . . 4 . 2 S . . .
 . . . 4 . 2 . . . .
 . . . . . 2 . . . .
