 . . . . . . . . . .
 2 2 . . . . . . . 4
 . 2 . . M . S . . 4
 . 2 . . . . . . . .
 . . . . . . 3 3 3 .
 . . . . . . . . . .
 . . . . . . . . . .
 . . . . 0 . . . . .
 . . . 0 0 0 . 1 1 .
 . . . . 0 . . 1 1 .
