 . . . 1 1 . . . . .
 . . . 1 1 . . . M .
 . . S . . . . . . .
 3 . . . . 2 2 2 . .
 3 . . 0 . . . . . .
 3 . 0 0 0 . . . . .
 . . . 0 . . . . . .
 . . . 0 . . . . . .
 . . . . . 4 . . . .
 . . . . . 4 . . . .
