 . 3 . . . . . 2 . .
 . . 3 . . . 2 . . .
 . . . 3 . 2 . . . .
 . . . . . 2 . . . .
 . . 0 . . . . . 1 .
 . . . 0 0 0 . 1 . 1
 . . 0 . . . . . 1 .
 . . . . . . . . . S
 . . . . . . . M . .
 . . . 4 4 . . . . .
