 . . . . 0 . . . . .
 . 0 . 0 . . . 2 . .
 . . 0 . . . 2 . . .
 . . 0 . . 2 . . 1 .
 . . 0 . . S . 1 . 1
 . . . . . . . . 1 .
 . . . . . . . . . .
 . . . 3 . . 4 4 . .
 . . 3 . . . . . . .
 . 3 . . . . . M . .
