 . 4 . . . . . . . .
 . 4 . S M . 1 1 . .
 . . . . . . 1 1 . .
 . . 2 . . . . . 1 .
 . . 2 . . . . . . .
 . . 2 . . . . 0 . .
 . . . . . . 0 0 0 .
 . . . . . . . 0 . .
 . . 3 3 3 . . . . .
 . . . . . . . . . .
