 . . . . . . . . . .
 . . . 3 3 3 . . . .
 . 0 . . . . . . . .
 . 0 . . . . 1 . . 4
 . 0 . . . . 1 . 4 .
 . 0 . . . . 1 . 4 .
 . 0 . . . . 1 . . .
 . . . . . . . . . .
 M . . . . S . . . .
 . . . . 2 2 2 . . .
