 4 4 4 . . . . . . .
 . . . . . 0 . . S .
 . . . . . . 0 0 0 .
 . . . . . 0 . . . .
 . . 1 . . . . . . .
 . 1 . 1 . . . . . .
 . . 1 . . . 2 . . .
 3 . . . . 2 . . . .
 . 3 . . 2 . . . . .
 . . 3 . . . . . M .
