 . . . . . M . . . .
 . . . 0 . . . . . .
 . . 0 0 0 . . 1 . .
 . . . 0 . . 1 1 . .
 . 3 . . . . 1 1 . .
 . 3 . . . . . . . .
 . 3 . . . . . . . .
 . . . . . . 2 . . .
 4 4 . . . . 2 S . .
 . . . . . . 2 . . .
