 . . 1 1 . . . . 0 .
 . . 1 1 . . . 0 0 0
 . . . 1 . M . . 0 .
 . . . . . . . . . .
 . 2 . . . . . . . .
 . 2 . . . . . S . .
 . 2 . . . . 3 . . .
 . . . . . . 3 . . .
 . . 4 4 . . 3 . . .
 . . . . . . . . . .
