 . . . . . . . 1 . .
 . . . 2 . . 1 . 1 .
 . S 2 . . . . 1 . .
 . . . 2 . . . . . .
 . . . . 2 . M . 4 4
 . . 0 . . . . . . .
 . . 0 . 3 . . . . .
 . . 0 . . 3 . . . .
 . 0 . 0 . . 3 . . .
 . . . . . . . . . .
