 . . . . . . . . . .
 2 . . . . . . . . .
 2 . . . 1 1 . . . .
 2 . . . 1 1 . . . .
 . . . . . . . . . M
 3 S . . . . . . . .
 3 . . . 0 . . . 4 .
 3 . . 0 0 0 . . 4 .
 3 . . . 0 . . . . .
 . . . . . . . . . .
