 . . . . . . . . M .
 . . . . S . . . . .
 . . . . . 0 . . . .
 . 2 2 2 . 0 . . . .
 . . . . . 0 . 4 4 .
 . . . . . 0 . . . .
 1 . . . . 0 . 3 . .
 1 . . . . . . 3 . .
 1 . . . . . 3 3 . .
 1 . . . . . . . . .
