 . . . . 4 4 . . . .
 . . . . . . . . 1 .
 . . . 0 . 0 . 1 . 1
 . . . . 0 . . . 1 .
 . . . . 0 . . . . .
 . . . . 0 . . . . .
 . . . . S . . . . .
 . . 3 . 2 2 . . . M
 . 3 . . . 2 . . . .
 3 . . . . . 2 . . .
