 . 4 4 . . . 2 . . M
 . . . . . . . 2 . .
 . . . . . . . . 2 .
 . 1 1 . . . S . . .
 1 . 1 . . 3 . . 0 .
 . 1 . . 3 . . . 0 .
 . . . 3 . . . . 0 .
 . . . . . . . 0 . 0
 . . . . . . . . . .
 . . . . . . . . . .
