 . . 1 1 1 1 . . . .
 . . . S . . 1 . . .
 . . . . . . . . . .
 3 3 3 . . 0 . . . .
 . . . . . 0 . . . .
 . . . . . 0 . . . .
 M . 2 . . 0 . . 4 4
 . . 2 . . 0 . . . .
 . . 2 . . . . . . .
 . . . . . . . . . .
