 . . . . . . . . . .
 . . . . 2 2 2 . . 4
 . 1 1 . . . . S . 4
 . 1 1 . . . . . . 4
 . . . . . . . . . .
 M . . . 0 . . . . .
 . . . 0 0 0 . 3 . .
 . . . . 0 . . 3 . .
 . . . . . . . 3 . .
 . . . . . . . . . .
