 . . . . 3 . . . 1 .
 . . . 3 . . . 1 . 1
 . . 3 . . 2 . . 1 .
 S . . . 2 . . . . .
 . . . 2 . . M . . .
 . . . . . . . . 0 .
 . . . . . 4 . . 0 .
 . . . . 4 . . . 0 .
 . . . . 4 . . 0 . 0
 . . . . . . . . . .
