 . . . 2 . . . . S .
 . . 2 . . 0 . . 4 .
 . 2 . . . . 0 . 4 .
 . . . . M . 0 . . .
 . . 1 . . . 0 . . .
 . 1 . 1 . 0 . 0 . .
 . . 1 . . . . . . .
 . . . . 3 . . . . .
 . . . . . 3 . . . .
 . . . . . . 3 . . .
