 . 0 0 0 0 0 . . . .
 . . S . . . . . . M
 . . . . . . . . . .
 . . . . . . . . . .
 . . . . . . . . . .
 4 . . . . . . . . 1
 4 . . . . . . . . 1
 . . 3 . . . . . . 1
 . . 3 . . 2 2 2 . 1
 . 3 3 . . . . . . .
