 . 2 2 2 . . . . . .
 . . . . . . . M . .
 . . . . . . . . . .
 . . . . . . . . 4 .
 0 . . 1 1 1 1 . 4 .
 0 . . . . . 1 . . .
 0 . . . . . . . . .
 0 . . . . . . . . .
 0 . . . . . . 3 3 3
 . . S . . . . . . .
