 . . . . . . . . . .
 3 . . . . . . . . .
 3 . . . 2 2 2 . . .
 3 3 . . . . . . 1 .
 . . . . M . . . 1 .
 . . . . . . . . 1 .
 . 0 0 0 0 0 . . 1 .
 S . . . . . . . . .
 . . . 4 4 . . . . .
 . . . . . . . . . .
