 0 . . . S . 3 . . .
 . 0 0 0 . . . 3 . .
 0 . . . . . . . 3 .
 . . 4 4 4 . . . . .
 . . . . . . . 1 . .
 . . . . . . 1 . 1 .
 . . . . . . . 1 . .
 . . . . 2 . . . . .
 . . . 2 . . . . . M
 . . 2 . . . . . . .
