 2 . . . . . 1 1 1 1
 2 S . . . . . . . .
 2 . . . . . . . . .
 . . . . . . . . . .
 . . . . . . . . . .
 . . . 3 . 0 0 0 0 0
 . . . 3 . . . . . .
 . . . 3 3 . . . . .
 . 4 . . . . . . . .
 . 4 . . . . . . . M
