 M . S 3 3 3 . . . .
 . . . . . . . . . .
 . . . . . . . . . .
 2 . . . . . . . 4 4
 2 . . . . . . . 4 .
 2 . . . . . 0 . . .
 . . . . . 0 0 0 . .
 . . . . . . 0 . . .
 1 1 . . . . . . . .
 1 1 . . . . . . . .
