 . . . . . . . . . 4
 S . 3 3 . . . . . 4
 . . 3 . . . . 2 . .
 . 3 . . . . 2 . . .
 . . . . . 2 . . . .
 . . 1 . . . . 0 . .
 . 1 . 1 . . . 0 . .
 . . 1 . . . . 0 . .
 M . . . . . 0 . 0 .
 . . . . . . . . . .
