 . . . . . . . . 4 .
 . . . 3 3 3 . . 4 .
 . . . . . . . . . .
 . . . . S . . . . .
 . . . . 2 2 2 . . .
 . 1 1 . . . . . 0 .
 . 1 1 . . . . 0 . .
 . . . . . . 0 0 0 .
 . . . . . . . 0 . .
 . . . . . M . . . .
