 . . . 1 1 . . 2 2 2
 . . . 1 1 . . . . .
 . . . . . . . . . .
 . . . . . . . . . .
 . . . . . . . . . .
 . . 0 . . . . S . .
 . 0 0 0 . . 3 . M .
 . . 0 . . . 3 . . .
 . . . . . . 3 . . .
 . 4 4 . . . 3 . . .
