 . . . . . . . . . .
 . . . . . . M . . 2
 0 0 0 0 0 . . . . 2
 . . . . . . . . . 2
 . . . . . . . . . S
 3 . 4 4 . . . . . .
 3 . . . . . . . . .
 3 . . . . . 1 . . .
 . . . . . 1 1 1 1 .
 . . . . . . . . . .
