 . . . . . . . . . .
 . . 0 . . . . . . .
 . . 0 . . . . . . .
 . . 0 . . . 4 4 . .
 . . 0 . . . . . . 1
 . . 0 . . . . . . 1
 . . . . 2 S . . 1 1
 . . . . 2 . . . . 1
 3 3 3 . 2 . . . . .
 . . . . . . M . . .
