 M . . . . . . . . .
 . . . . . . . S . .
 . . . . . . 0 . . 2
 . . . . . 0 0 0 . 2
 . . 4 4 . . 0 . . 2
 . . . . . . . . . .
 . . . 3 3 3 . . . .
 . . . . . . . . . .
 . 1 1 . . . . . . .
 . 1 1 1 . . . . . .
