 . . . . . . . . . .
 2 . . . . . . . 0 .
 2 . . . . . . 0 0 0
 2 . . . . . . . 0 .
 . S . . . . . . . .
 . . 4 . . . 3 3 3 .
 4 4 . . . . . . . .
 . . . . . . . M . .
 . . 1 1 . . . . . .
 . . 1 1 . . . . . .
