 . . . . . . . 2 2 .
 . . 3 3 3 . . 2 . .
 . . . . . . . 2 . .
 . . . . . . S . . .
 . . . 0 0 0 0 0 . .
 . . . . . . . . . .
 . . . M . . . . 1 .
 . . . . . . . . 1 .
 . . . . 4 . . . 1 .
 . . . . 4 . . . 1 .
