 . . . S 1 . . . M .
 . . . 1 . 1 . . . .
 . . . . 1 . . . . .
 . . . . . . 0 . 0 .
 . . . . . . . 0 . .
 . . . . 4 4 . 0 . .
 . 2 . . . . . 0 . .
 . . 2 . . . . . . 3
 . . . 2 . . . . 3 .
 . . . . . . . 3 3 .
