 . . 3 . . . . . . .
 3 3 3 . . . . . . .
 . . . . . M . . . .
 . 2 . . . . . 0 . .
 . 2 . . . . . 0 S .
 . 2 . . . . . 0 . .
 . . . . . . . 0 . .
 . . 1 1 1 1 . 0 . .
 . . . . . . . . . .
 . . . . . 4 4 . . .
