 . . . . . . . . . .
 . S . . . 4 . 3 . .
 . . 0 . . 4 . 3 . .
 . 0 0 0 . . . 3 3 .
 . . 0 . . . . . . .
 . . . . . . . . . .
 M . . . . . . . 2 .
 . . 1 1 . . . . 2 .
 . . 1 1 . . . . 2 .
 . . . . . . . . . .
