 . . . . . . 3 3 3 .
 . . . . 1 . . . . .
 . . . . 1 . . . . .
 . . . . 1 . . . . .
 . . . . 1 . . . 2 .
 0 . . . . . M . 2 .
 0 0 0 0 0 . . . 2 .
 . . . . . . . . . .
 . . . . S . . . . .
 . . . . . . . 4 4 .
