 . . . . . . 4 4 . .
 . . . 0 . . . . . .
 . . . . 0 0 0 . . .
 3 . . 0 . . . . . .
 . 3 . . . . . . . .
 S . 3 3 . . . . 1 .
 2 . . . . . . 1 . 1
 . 2 . . . . . . 1 .
 . . 2 . . . M . . .
 . . . . . . . . . .
