 . 0 . . . 2 2 2 . .
 0 0 0 . . . . . . .
 . 0 . . . . . . . .
 . . . . . . . . . .
 . . . . . . . . . .
 . M . . . . . . 3 .
 . . . S . . . . 3 .
 . . 1 1 . . . . 3 .
 . . 1 1 . 4 4 . . .
 . . 1 . . . . . . .
