 0 . 0 . . . . 3 . .
 . 0 . . . . 3 . . .
 . 0 . . . 3 . . . .
 . 0 . . . . . . . .
 . . . . . . . . . .
 . . . . . 1 . . 4 .
 . . . . 1 . 1 . 4 4
 . . 2 . . 1 . . . .
 . 2 . . . . . . M .
 2 . . . . . . . . S
