 . . . . . . . . . .
 . . . . . . . . 4 4
 . . . . . . . . . .
 3 . . . . . 2 . S .
 3 . . . . . 2 . . .
 3 . . 0 . . 2 . . .
 . . 0 0 0 . . . . .
 . . . 0 . . 1 . . .
 M . . . . . 1 1 . .
 . . . . . . 1 1 . .
