 . . . . . . . . . .
 . . . 1 1 . S . . .
 . . . 1 1 . . . . .
 . . . . . . . M . 4
 . . . . . . . . . 4
 . . . . 2 . . . . .
 . . 2 2 2 . . 0 . .
 . . . . . . 0 0 0 .
 . . 3 3 3 . . 0 . .
 . . . . . . . . . .
