 . 3 3 3 . . . . . .
 . 3 . . . . 2 2 2 .
 . . . 0 . . . . . .
 . . 0 0 0 . . . . .
 S . . 0 . . . . 1 1
 M . . . . . . . 1 1
 . . . . . . . . . .
 . . . . . . . . . .
 . 4 4 . . . . . . .
 . . . . . . . . . .
