 3 . . . . 0 . . . .
 3 . . . 0 0 0 . . .
 3 . . . . 0 . . . .
 3 . . . . . . . . .
 . . . S . . . . . .
 . . . . 1 1 . . . .
 . . . . 1 1 . . . .
 . . . . . . . . . .
 . . . . . M . . 4 4
 . 2 2 2 . . . . . .
