 . . . . . . 4 4 . .
 . . 3 3 3 . . . . .
 . . S . . . . . . .
 . . . 0 . . . . . .
 M . 0 0 0 . . 1 . .
 . . . 0 . . . . 1 1
 . . . . . . . . 1 1
 . . . . 2 2 2 . . .
 . . . . . . . . . .
 . . . . . . . . . .
