 . . . . . . . . . .
 . . . . . 0 0 0 0 0
 . . . . 0 . . . . .
 . . . . . . . . . .
 . 3 3 3 . . . 2 2 2
 . . . . . . . . . .
 . . . . . . . . . S
 . . . . . M . . . .
 . . 4 4 . . . . . .
 . . . . . 1 1 1 1 .
