 . . . . . . . . M .
 . . . . . . . . . .
 . . . 0 0 0 0 0 . .
 . . . . . . . . . .
 . . . . . . 4 . . .
 . . . . . . 4 . 3 .
 . 2 2 2 . . . S 3 .
 . . . . . . . . 3 3
 . 1 1 1 1 . . . . .
 . . . . . . . . . .
