 . . . . . 0 . . . .
 . 1 . . . . 0 0 0 .
 1 . 1 . . 0 . . . 0
 . 1 . . . . . . . .
 . . . . 2 . . . . .
 . . . 2 . S . . . .
 . . 2 . . . . . . .
 . . . . 4 . . . 3 .
 . . . . 4 . . 3 . .
 . . . . . . 3 . . M
