 . . . . . . . . . .
 . 1 . . . . . . . .
 1 . 1 . . . 3 . . .
 . 1 . . . . . 3 S .
 . . . . . M . . 3 .
 4 . . . . . . . . 3
 4 . . . . 0 . . . .
 . . 0 0 0 . . . . 2
 . . . . . 0 . . 2 .
 . . . . . . . 2 . .
