 . . . . 0 . . . . .
 . S . . 0 . . . . .
 3 3 3 . 0 . . . . .
 . . . . 0 . . . . .
 . . . . 0 . . . . .
 . . . . . . . 1 . M
 . . . 2 2 2 . 1 . .
 . . 2 . . . . 1 . .
 . . . . 4 4 . 1 . .
 . . . . . . . . . .
