 . . . 2 2 2 . . . .
 . 4 . . . . . . . .
 . 4 . . . . . . . .
 . . . . . . 0 . . .
 . . . 1 . . 0 S . .
 . . . 1 . . 0 . . .
 . . . 1 . . 0 . M .
 . 3 . 1 . . 0 . . .
 . 3 . . . . 0 . . .
 . 3 . . . . . . . .
