 . . . . . . . 3 3 3
 . . . 2 . . . . . .
 . . . 2 . . 1 . . .
 . . . 2 . . 1 1 . .
 . . . . . . 1 1 . .
 . . 4 . . . . . . .
 . . 4 . . . . . . .
 . . . . . 0 . . S .
 . . . . 0 0 0 . . .
 . . . . . 0 . . . M
