 . . . . . . . . . 1
 . . . . . . . . . 1
 . . . 0 . . . . . 1
 . . . 0 . 4 4 . . 1
 . . . 0 . . . . . .
 . . . 0 . . . 2 . .
 . . . 0 . . . 2 . .
 . 3 . . S . . 2 . .
 . 3 3 3 . . . . . .
 . . . . . . . M . .
