 . . S . . . . . . .
 . 4 . . . 2 . . . .
 . 4 . . 2 . . 0 . .
 . . . 2 . . . 0 . .
 . . . . . . . 0 . .
 . M . . . . 0 . 0 .
 . . . . . . . . . .
 . 1 . 1 . . 3 . . .
 . . 1 . 1 . . 3 . .
 . . . 1 . . . . 3 .
