 . . 0 . . . M . . .
 . . 0 . 0 . . . . .
 . . . 0 . . . . 2 .
 . . . 0 . . S 2 . .
 . . . 0 . . 2 . . .
 . . . . . . . . . .
 . . . 1 . . . . . 3
 4 . 1 . 1 . . . 3 .
 4 . . 1 . . . 3 . .
 . . . . . . . . . .
