 . . . . 3 . . . . .
 . 1 1 . 3 . . . . .
 . 1 1 . 3 . . 4 . .
 . . . . . . . 4 . .
 . . . . S . . . . .
 . . . . . M . . . .
 . . . 2 . . . 0 . .
 . . . 2 . . 0 0 0 .
 . . . 2 . . . 0 . 0
 . . . . . . . . . .
