 . . . . . . . . . .
 . . 0 . 4 . . . . .
 . . 0 . 4 . . 1 . .
 . . 0 . . . . 1 . .
 . . 0 . . M . 1 . .
 . . 0 . . . . 1 . 2
 . . . . . . . . . 2
 . . . . . 3 . . . 2
 . . 3 3 3 . . S . .
 . . . . . . . . . .
