 . . S 1 1 . . . . .
 . . . 1 1 . . . . .
 . . . . . . . . 0 .
 . . . . M . . 0 0 0
 . . . . . . . . 0 .
 . . 2 . . . . . . 0
 . . 2 . . . . . . .
 . . 2 . . . . . . .
 . . . . . . . . 4 .
 . 3 3 3 . . . . 4 .
