 . . . . . . . . . .
 . . . . 0 . . . . .
 . . . 0 0 0 . . . .
 . . . . 0 . . 3 3 3
 . 2 . . . . . . . .
 . 2 2 . . . . . . .
 . 2 . . . . . . . .
 . . . M . S . . . 4
 . . . . . 1 1 . . 4
 . . . . . 1 1 . . .
