 S . 2 2 . M . 3 . .
 . . . 2 . . . . 3 .
 . . . . 2 . . . . 3
 . . . . . . . . . .
 . . . 0 . . . . . .
 . . . . 0 0 0 . . .
 . . . 0 . . . . . .
 . . . . . . . 1 . .
 4 4 . . . . 1 . 1 .
 . . . . . . . 1 . .
