 . 4 . . 3 . . . . .
 4 . . . . 3 . . . .
 4 . . 2 . . 3 . . .
 . . . . 2 . . . . .
 . . . . . 2 . . . .
 . 0 . 0 . . . 1 . .
 . . 0 . . . 1 . 1 .
 . . 0 . M . . 1 . .
 . . 0 S . . . . . .
 . . . . . . . . . .
