 . . . . . . . . . .
 . . . . . . S . . .
 . 0 0 0 0 0 . . . .
 . . . . . . . . . .
 . . . . . . 3 . M .
 . 2 . . . . 3 . . .
 . 2 2 2 . . 3 . 1 .
 . . . . . . . . 1 .
 . . 4 . . . . . 1 .
 . . 4 . . . . . 1 .
