 . . . . . . . . . .
 . 0 . . . . 3 . . .
 . 0 . . . . 3 3 3 .
 . 0 . . . . . . . .
 . 0 . 1 1 1 1 . . .
 . 0 . . . . . . . .
 . . . . . . . . 2 .
 . . . . . . S . 2 .
 . M . . . . . . 2 .
 . . . . . 4 4 . . .
