 M . . 4 4 . . . 2 .
 . . . . . . . 2 . .
 . . . . . . 2 . . .
 0 S . . . 2 . . . .
 . 0 0 0 . . . . 1 .
 0 . . . . . . 1 . 1
 . . . 3 . . . . 1 .
 . . . . 3 . . . . .
 . . . . . 3 . . . .
 . . . . . . . . . .
