 . . . . . . . . . .
 . . . . . . . 2 . .
 . . . 1 1 . . 2 . .
 . . . 1 1 . 2 2 . .
 . . . . . . . S . 4
 . . 0 . . . 3 . . 4
 . 0 0 0 . . 3 . . .
 . . 0 . . . 3 . . .
 . . . . . . . . . .
 M . . . . . . . . .
