 . . . . 2 . . . . .
 . . . 2 . . . . 1 .
 . . 2 . . . . 1 . 1
 . . . . . . . . 1 .
 . . . . . . 3 . . .
 . 0 . . . . S 3 . .
 . 0 . . M . . . 3 .
 . 0 0 . . . . . . .
 0 . 0 . . . . 4 4 .
 . . . . . . . . . .
