 2 . . . . . . . . .
 . 2 . . . . . . 1 .
 . . 2 . . . . 1 . 1
 . . . . . . . . 1 .
 . . . . . . 3 . . .
 . . M . . 3 3 . 4 .
 . . . . 3 S . . 4 .
 . . . . . . 0 . . .
 . . . 0 0 0 . . . .
 . . . . . . 0 . . .
