 . . . 2 . . . . . .
 . . . . 2 . . . . .
 3 . . . . 2 . . . .
 . 3 . . . . . 1 . .
 . . 3 . . . 1 . 1 .
 . . . . . . . 1 . .
 . . . 0 . . . . . .
 . . . . 0 0 0 . 4 4
 . M . 0 . 0 . S . .
 . . . . . . . . . .
