 . . S . . . . . . .
 . . . 0 . . . 4 4 .
 . . 0 0 0 . . . . 4
 . . . 0 . . . . . .
 . . . . . . 1 1 . .
 . . . . . . 1 1 . .
 . . . . . . . . . M
 . . . . . . . . . .
 . 3 3 3 . . . . . .
 . . . . . . . 2 2 2
