 2 . 2 . . . . . . .
 . 2 . . . . . . . .
 2 . . . . 1 . . . M
 . . 3 . 1 . 1 . . .
 . 3 . . . 1 . . . .
 3 S . 0 . . . . . .
 . . . . 0 0 0 . . .
 . . . 0 . . . . . .
 . . . . . . . 4 4 .
 . . . . . . . . . .
