 . . . . . . . 3 3 .
 . . 0 . . . 3 . . .
 S . 0 . . 3 . . . .
 . . 0 . . . . . . .
 . 0 . 0 . . . 1 . .
 . . . . . . 1 . 1 .
 . 4 4 . . . . 1 . .
 . . . . 2 . . . . .
 . . . 2 . . . . . .
 M . 2 . . . . . . .
