 . M . . . . . 2 . .
 . . . . 1 . . 2 . .
 . . . . 1 . . 2 . .
 . . . . 1 . . . . .
 . . 0 . 1 . . 3 . .
 . S 0 . . . . . 3 .
 . . 0 . 4 . . . 3 .
 . . 0 . 4 . . . 3 .
 . . 0 . . . . . . .
 . . . . . . . . . .
