 . . . . . . . . . .
 3 . . . . . . . . .
 3 S . . . . . . 1 .
 3 . 0 . . . . . 1 .
 . . 0 . . 4 4 . 1 .
 . . 0 . . . . . 1 .
 . . 0 . . . . . . .
 . . 0 . . . . . . M
 . 0 . . . . . . . .
 . . . . . . 2 2 2 .
