 . . . . . . . 2 2 2
 . . . . . . . . 2 .
 S . . . . . . . . .
 1 . . 0 0 0 0 0 . .
 1 . . . . . . . . .
 1 . . . . . M . . 4
 1 . . . . . . . . 4
 . . . . . . . . . .
 . . . . . . . . . .
 3 3 3 . . . . . . .
