 . . . . . . 2 . . .
 . . 3 . . S 2 . . .
 . . 3 . . . 2 . . .
 . . 3 . . . . . . .
 . . . . . . . . . .
 . . . . 0 . 1 1 1 1
 . . . . 0 . . . . .
 . . . . 0 . . 4 . .
 . . . . 0 . . 4 . M
 . . . . 0 . . 4 . .
