 . . . . . . . 1 . .
 . 2 2 2 . S . 1 . .
 . . . . . . . 1 . .
 . . . . . . . 1 . .
 . . . . . 0 . . . .
 . . . . . 0 . 4 4 .
 . . . . . 0 . . . 4
 3 3 3 . . 0 . . . .
 . . . . . 0 . . M .
 . . . . . . . . . .
