 . . . . . . . . . .
 . . . . . . . 4 . .
 . . M . 2 . . 4 . .
 . . . . . 2 . . 4 .
 . . . . . . 2 . . .
 . S . 1 . . . . . .
 . . 1 . 1 . . . 0 .
 3 . . 1 . . . . 0 .
 . 3 . . . . . . 0 .
 . . 3 . . . . 0 . 0
