 2 2 2 . . . . . . .
 . . . . . . . . . .
 . . 0 . . . . . . .
 S . 0 . . . . . . .
 . . 0 . . . . . . 1
 4 . 0 . . . . . . 1
 4 . 0 . . . . . . 1
 . . 0 . . . . . . 1
 . . . . . . . . . .
 . 3 3 3 . . M . . .
