 . M . . . . 1 . . .
 . . . . . 1 . 1 . .
 . . . . . . 1 . . .
 . S . 2 . . . . . .
 . . . . 2 . . . 4 4
 . . . . . 2 . . . .
 . 3 . . . . . . . .
 . . 3 3 . . . . . 0
 . . . 3 . . 0 0 0 .
 . . . . . . . . . 0
