 3 3 3 . . 1 1 1 1 .
 . . . . . . . . . .
 . . . . 0 . . . . .
 . . . . 0 . . . . .
 . . . . 0 . . . . .
 . . . . 0 . . . . .
 . . . . 0 . 2 2 2 .
 . 4 . . . . . . S .
 . 4 . . . . . . . .
 . 4 . . . . . . . M
