 . . 4 4 4 . M . . .
 . . . . . . . . . .
 . . . . 3 3 3 . 1 1
 . . . . S . . . 1 1
 . . . . . . . . . .
 . . . . 0 . . . . .
 . . . 0 0 0 . . . .
 . . . . 0 . . . . .
 . . . . . . . . . .
 . 2 2 2 . . . . . .
