 . M . . . 2 . . . .
 . . . . . . 2 2 2 .
 . . . . . . . . . .
 . . . . . 0 . . 4 .
 . . . 1 . 0 . . 4 .
 . . . 1 . 0 . . . .
 . . . 1 . 0 . . . .
 . . . 1 . 0 . . . .
 . . . S . . . . . .
 3 3 3 . . . . . . .
