 3 3 3 . 4 4 . . . .
 . . . . . . . . . .
 . . . . . . . M . .
 . . . 0 . . . . . .
 . . . 0 . . . . . .
 . . S 0 . . . 1 . .
 . . . 0 . . 1 . . .
 . . . 0 . . 1 . . 2
 . . . . . . 1 . . 2
 . . . . . . 1 . . 2
