 . 0 . . . . . 4 . .
 . . 0 0 0 . . 4 . .
 . 0 . . . . . . . .
 . 0 . . 2 . . . 1 .
 . . . 2 . . . 1 . 1
 . . 2 . . . . . 1 .
 . . . . . . . . . .
 . . . . . . . . 3 .
 S . . . . . . 3 . .
 . . M . . . 3 . . .
