 . . . . . . . . . 4
 . . . . 2 . . . . 4
 . . . 2 . . . . . .
 . . 2 . . . . 0 . .
 . . . . 0 0 0 . . .
 . . . . . . . 0 . .
 S . 3 3 . . . . . .
 . . 3 . . 1 . . . .
 . 3 . . 1 . 1 . . .
 . . . . . 1 . . . M
