 . . . . . 1 . . . .
 . . . . . . 1 1 . 4
 M . . . S . 1 1 . 4
 . . 0 . . . . . . .
 . 0 0 0 . . . . . .
 . . 0 . . . . . . .
 . . . . . . . . . .
 . . . 2 . . . 3 3 3
 . . . 2 . . . . . .
 . . . 2 . . . . . .
