 . . . . . . . . . .
 3 3 3 . . . . . . .
 . . . S . . . . . .
 . . . . . . . . . .
 . . . . . 0 . . . .
 2 2 2 . 0 0 0 . . .
 . . . . . 0 . . . .
 . 1 . . . . . . . .
 . . 1 1 . . 4 . . .
 . . 1 1 . . 4 . M .
