 . . . . . . . . . .
 . . . . . 0 0 0 0 0
 . . 4 4 . . . . . .
 . . . . . . . M . .
 . 1 . . . . . . . .
 . 1 . . . 3 . . . .
 . 1 . . . 3 . . . .
 . 1 . . . 3 . . 2 .
 . . . . . . 3 . 2 S
 . . . . . . . . 2 .
