 . . . . . . . . . 3
 . . . . . 0 . . . 3
 . . . . 0 0 0 . . 3
 . . M . . 0 . . . .
 S . . . . . . . . .
 . 2 . . . . . . . .
 . 2 . . . . . . . .
 . 2 . . . . . . . .
 . . 2 . 4 . 1 1 . .
 . . . . 4 . 1 1 . .
