 . . . . 0 . . . 4 4
 2 2 2 . 0 . 3 . . .
 . . . . 0 S 3 . . .
 . . . . 0 . 3 3 . .
 . . . . 0 . . . . .
 . . . . . . . . . .
 . . . 1 . . . . . .
 . . . 1 . . . . . .
 . . . 1 . . . . M .
 . . . 1 . . . . . .
