 4 . . . . 2 . . . 1
 4 . . . 2 . . . 1 .
 . . . 2 . . . 1 . 1
 . 3 . . . . . . 1 .
 . . 3 . . . . . . .
 . . . 3 . . . . . .
 . . . . . . . . . .
 M . . . . . 0 . . .
 . . . . . . S 0 0 0
 . . . . . . 0 . . .
