 . . 1 . . . . 4 . .
 . . 1 . . . . . 4 .
 2 . 1 . . . . . 4 .
 2 . 1 . . . . . . .
 2 . . . 0 0 0 0 0 .
 . . . . . . . . . .
 . . . S . . . . . .
 . . . . . . . . 3 .
 . . . . . . . . 3 .
 M . . . . . . . 3 .
