 . . . . . M . . . .
 . . . . . . . . . .
 3 . . . . . . . . .
 . 3 . . 1 1 . . . .
 . . 3 . 1 . 1 . 4 .
 2 . . . . 1 . . 4 .
 . 2 . . . . . . S .
 . . 2 . . . . . . 0
 . . . . . . 0 0 0 .
 . . . . . . . . . 0
