 . . . 2 2 2 . . . .
 . . . . . . . . . .
 . . . . . . . S . .
 0 . . . . . . . . .
 0 . . . 1 . . . . .
 0 . M . 1 . 3 3 3 .
 0 . . . 1 . . . . .
 0 . . . 1 . . . . .
 0 . . . . . 4 4 . .
 . . . . . . . . . .
