 . . . . . . . 2 2 2
 . . . . . . . . . .
 . 1 1 . . . . . . .
 . 1 1 . . . . . 0 .
 . . S . 3 . . 0 0 0
 . . . 3 . . . . 0 .
 . . . 3 . . . . . .
 4 4 . 3 . . . . . .
 . . . . . M . . . .
 . . . . . . . . . .
