 . . . . 2 2 2 . . .
 M . . . . . . 2 . .
 . . 0 . . . . . . .
 . . 0 . 3 3 3 . . .
 . . 0 . . . . . . .
 . . 0 . . . 4 4 . .
 . . 0 . . . . . . .
 . . . . . . . . . .
 . . 1 1 1 1 . S . .
 . . . . . . . . . .
