 . . . . . . . . . 3
 . . . . . . . . 3 .
 2 . . . . . 3 3 . .
 . 2 . . . . . . . .
 . . 2 . . . . . . .
 . . . . . . . . . .
 . . 0 . . 1 . . . 4
 . . 0 . 1 . 1 . . 4
 . . 0 . . 1 . . . .
 S 0 . 0 . . . . . M
