 . . . . . . . . . .
 . . . M . . . . 1 1
 . . . . . . . . 1 1
 . . . . . . . . . .
 . . . . . . . . . .
 . S . . . 0 0 . . .
 . 3 . . 0 0 0 . . .
 . 3 . . . 0 . . 4 4
 . 3 . . . . . . . .
 . . . . . . 2 2 2 .
