 . . . . . . . . . 3
 . . . . . . 4 . . 3
 . . . . . . 4 4 . 3
 . . 1 1 . . . . . .
 . . 1 1 . M . . . .
 . . . . . . . 0 . .
 . . . . . . 0 0 0 .
 . 2 2 2 . . . 0 . .
 . . . . S . . . . .
 . . . . . . . . . .
