 . 2 . . . . . . . .
 . 2 . . . S 4 4 . .
 . 2 . . . . . . . .
 . . . . . . M . . .
 0 0 0 0 0 . . . . .
 . 0 . . . . . . . .
 . . . . . 3 3 3 . .
 . . . . . . . . . .
 . . . . . . . . . .
 . . . . . 1 1 1 1 .
