 . . . . . . . . . .
 . M . . . 3 3 3 . .
 . . . 0 . . . . . .
 . . . 0 . . . 4 4 .
 . 1 S 0 0 . . . . .
 . 1 . 0 . . . . . .
 . 1 . 0 . . . . . .
 . 1 . . . . . 2 . .
 . . . . . . . 2 . .
 . . . . . . . 2 . .
