 . . . . . . . 2 . .
 . 3 . M . . . 2 . 1
 . 3 . . . . . 2 . 1
 . 3 . . . . . . . 1
 S . . . . . . . . 1
 . . . . . . . . . .
 . . . . . 0 . . . .
 . 0 0 0 0 0 . . . .
 . . . . . . . . . 4
 . . . . . . . . . 4
