 . . . . . 4 . . . .
 . . . . . 4 . . . .
 . 2 2 2 . . . . . M
 . . . . . . . . . .
 . . S . . . . . . .
 . . 1 1 1 1 . . . .
 . 1 . . . . . . . .
 . . . 3 3 3 . . . .
 . . . . . . . . . .
 . . . 0 0 0 0 0 . .
