 4 4 . . . . . . 0 .
 . . . . . 0 0 0 . .
 . . . . . . . . 0 .
 . M . . . . . . . .
 . . . . . . . . . .
 . . . . . 1 . . . .
 2 . . . 1 . 1 . . .
 . 2 . . . 1 . . 3 3
 . . 2 . . . . . 3 .
 . . . . . . . 3 . S
