 . . 2 . . M . 3 3 3
 . . 2 . . . . . . .
 . . 2 . 4 4 . . . .
 . . . . . . . . . .
 . . . . . . . . . .
 . . . . S . . . . .
 . . . 0 . . . . . .
 . 0 0 0 0 0 . . . .
 . . . . . . . . . .
 . . . 1 1 1 1 . . .
