 M . . . . . . S . .
 . . 0 . . . . . . .
 . 0 0 0 . . . . . 4
 . . 0 . . . . . . 4
 . . . . . . . . . .
 . . . . . . . 2 . .
 . . . . . . . 2 . .
 . 1 . . 3 . . 2 . .
 . 1 1 . 3 . . . . .
 . 1 1 . 3 . . . . .
