 . . . . 4 . . . . .
 . . . . 4 . . 2 2 2
 . . . . . S . . . .
 . 0 0 0 0 0 . . 1 .
 . . . . . . . . 1 .
 3 . . . . . . . 1 .
 . 3 . . . . . . 1 .
 . 3 . . . . . . . .
 . 3 . . . . . . . M
 . . . . . . . . . .
