 . . 1 1 1 1 . . . .
 . . . . . . . . . .
 . . . . . . . . . 4
 . 2 2 2 . . . . . 4
 . . 2 . . . 3 . . .
 . . . . . . 3 . . .
 0 0 0 0 0 . 3 . . .
 . S . . . . . . . .
 . . . . . . . . M .
 . . . . . . . . . .
