 . . 4 . . . . . . 3
 . . 4 . . . . . 3 .
 . . . . . . . 3 . .
 . . . 2 . . . . . .
 . . 2 . . . . . . .
 . 2 . . . . . . . .
 . . . . . . . 0 . .
 . 1 . . . M . 0 . .
 1 . 1 . . . . 0 0 .
 . 1 . . . S 0 . 0 .
