 . . . . . . . . . .
 . . . 0 . 0 . . . .
 . . 0 0 0 . . . . .
 . . . 0 . . 3 3 3 .
 1 1 . . . . . . . .
 1 1 . . . . . S . .
 . . . . . . . 4 . .
 . . . 2 2 2 . 4 . .
 . . . . . . . . . .
 . . . . . . . . M .
