 . . . . . . 3 3 3 .
 . . . . . . . . . .
 . 0 . . . S . . . .
 0 0 0 . . . 1 1 . .
 . 0 . . . . 1 1 . .
 . . . . . . . . . M
 . . . . 4 . . . . .
 . . . 4 4 . . . . .
 . . . . . . . . . .
 . . . . 2 2 2 . . .
