 . . . . . . . . . .
 . M . . . 0 0 0 0 0
 . . . . . . . . . .
 . . . . . . . . . .
 . . . . 1 1 1 1 1 .
 . . . . . . . . . .
 . S . . 2 2 2 . 4 .
 3 3 3 . . . . . 4 .
 . . . . . . . . . .
 . . . . . . . . . .
