 . . . . . . . . . .
 . . . . . . . S . .
 . . 0 0 0 0 0 . . .
 . . . . . . . . . 3
 2 . . . . . . . . 3
 2 . . . 1 1 1 1 . 3
 2 . . . . 1 . . . .
 . . . . . . . M . .
 . 4 4 . . . . . . .
 . . . . . . . . . .
