 . . . . 0 0 0 0 0 .
 . . 3 . . . . . . .
 . . 3 . . . . . . .
 . . 3 . . S . 2 2 2
 4 . . . . . . . . 2
 4 . . . . . . . . .
 . . . . . . . . . .
 . . . . . . . . . .
 . . . . . . . . . .
 . . M . . 1 1 1 1 .
