 . . . 2 . . 3 . . .
 . . 2 . . 3 . . . .
 . 2 . . 3 . . . . .
 . . . . . . . 4 4 .
 . 0 . . . . . . . .
 . . 0 0 0 . . . . .
 . 0 . . . . 1 . . .
 . . . . . 1 . 1 1 .
 . . M . . . 1 . S .
 . . . . . . . . . .
