 . . . . . . . 1 . .
 . . . 1 1 1 1 . . .
 . . . . . . . . . .
 . . . . . . . . . .
 . . . . . . . 4 4 .
 . . . . . 0 . . . .
 . . . . . 0 . . . 3
 2 2 2 . . 0 . . . 3
 . . . . . 0 S . . 3
 . . . M . 0 . . . .
