 . . . . . . . . . 3
 . . . 1 . . . . 3 .
 . . 1 . 1 . . 3 . .
 . . . 1 . . . . . .
 . . . 1 . . . S . .
 0 . . . . . . . . .
 . 0 0 0 . . . . . .
 0 . . . . . . 2 . .
 . . . . . . 2 . . .
 . 4 4 . . 2 . . . M
