 . . . . . . . . . .
 . . . . . . . . . .
 . 0 . 1 . 2 2 2 . .
 . 0 . 1 . . . . . .
 . 0 . 1 . . . . S .
 . 0 . 1 . . . . . .
 . 0 . . . . . . 3 .
 . . . . . . . . 3 .
 M . . 4 4 . . . 3 .
 . . . . 4 . . . . .
