 . . . . . . 2 . 4 S
 . . . . . . 2 . 4 .
 . 3 3 3 . . 2 . . .
 . . . . . . . . . .
 0 0 0 0 0 . . . . .
 . . . . . . . . . .
 . . 1 . . . . . . .
 . 1 1 . . . . . . .
 . . 1 . . . . . . .
 M . 1 . . . . . . .
