 . . . . . 4 S . . .
 . . . . . . 4 . . .
 . . . . . . 4 . . .
 . . . . . . . . 0 .
 . . . . . . . . 0 .
 . . . M . . . . 0 .
 . . . . . . 1 . 0 .
 . 3 3 3 . . 1 . 0 .
 . . . . . . 1 . . .
 . . 2 2 2 . 1 . . .
