 . . 1 . . . 2 . . .
 . 1 . 1 . . . 2 . .
 S . 1 . . . . . 2 .
 . . . . . . . . . .
 . . . . . . 3 . . .
 . 0 0 . . . . 3 . .
 . . 0 . . . . . 3 .
 . . 0 . . . 4 . . .
 . 0 . 0 . . 4 . . .
 . . . . . . . . . M
