 . . . 2 . M . . . .
 . 2 2 2 . . . . 0 S
 . . . . . . . . 0 .
 . . . . . . . . 0 .
 . . . . . . . . 0 .
 . . . 1 . . . . 0 .
 . . . 1 . . . . . .
 . . . 1 . 3 3 3 . .
 . . . 1 . . . . . .
 . . . . . . 4 4 . .
