 . . . . . . 3 . . .
 . . . . 3 3 . S . M
 . . . . 3 . . . . .
 . . 0 . . . . 2 . .
 . . . 0 0 0 . . 2 .
 . . 0 . . . . . . 2
 . . . . 1 . . . . .
 . . . 1 . 1 . . . .
 . . . . 1 . . 4 4 .
 . . . . . . . . . .
