 . . . . . . . . . .
 M . . . . . 3 3 3 .
 . . . . . . . 3 . .
 1 . . . . . . . . .
 1 . . 4 4 . . 2 . .
 1 . . . S . . 2 . .
 1 . . . . . . 2 . .
 . . . . . . . . . .
 . . . . . 0 0 0 0 0
 . . . . . . . . . .
