 . 2 2 2 . . . . . .
 . . . . . . . 4 4 .
 . . . . . . . . . .
 . . . 0 . . . . . .
 . . . 0 . 1 . . . .
 . . . 0 . 1 . 3 3 3
 M . . 0 . 1 . . . .
 . . . 0 . 1 . . . .
 . . . . . 1 . . . .
 . . . . . . . S . .
