 . . . 2 . . . . . 3
 . . 2 . . . . . 3 .
 . 2 . . 0 . . 3 . .
 . . . . 0 . . . . .
 . . . . 0 . . . . .
 . . . 0 . 0 . . . .
 4 4 . . . . . . . .
 4 . . . . . . 1 S .
 . . . . . . 1 . 1 .
 M . . . . . . 1 . .
