 . . . . . . . . . .
 . . . . . 1 . 4 4 .
 3 . . . . 1 . . . .
 3 . . . . 1 . . . .
 3 . 0 . . 1 1 . 2 .
 . . 0 . . . . . 2 .
 . . 0 . M . . . 2 .
 . . 0 . . . . . . .
 . . 0 . . . . . . S
 . . . . . . . . . .
