 0 . . . . . . . . 1
 0 . . . . . . . . 1
 0 . . . . . . 3 . 1
 0 . . . . 3 3 3 . 1
 0 . . . . . . . . .
 . S . . . . 4 4 . .
 . 2 . . . . . . . .
 . 2 . . . . . . . .
 . 2 . . . M . . . .
 . . . . . . . . . .
