 . . . . . . . . 0 .
 . . 1 1 1 . . 0 0 0
 . . . 1 1 . . . 0 .
 . . . . . . . . . .
 . M . . . . . . . .
 . . . . . . . . . .
 . S . . . . 4 4 . .
 . . . . . . . . . .
 . . . . . . . . . .
 . 2 2 2 . . . 3 3 3
