 . . . . M . . . . .
 . . . . . . . . . .
 . . . . . 1 . 3 3 3
 . . . . . 1 . . . 3
 . . . . . 1 . . . .
 . . . . . 1 . . . .
 . . . . . . . . 4 .
 . . . 2 2 2 . . 4 .
 . . . . . . . S . .
 . . . 0 0 0 0 0 . .
