 . . 4 . . . . . . M
 . . 4 . . . S . . .
 . 4 . . . . . 2 . .
 . . . . . . 2 . . .
 . . . 0 . 2 . . . .
 0 0 0 . . . . . . .
 . . . 0 . . . . . .
 3 . . . . . 1 . . .
 . 3 . . . 1 . 1 . .
 . . 3 . . . 1 . . .
