 . . . 1 1 . . . . .
 . . . 1 1 . 2 . . .
 . . . . . . 2 . . .
 . . . . . . 2 . . M
 . . . . . . . . . .
 . . . 4 . . . . . .
 . 3 . 4 . . . S 0 .
 . 3 . . . . . 0 0 0
 . 3 . . . . . . 0 .
 . . . . . . . 0 . .
