 . 1 . . . . . . . .
 . 1 . . . . M . 0 .
 . 1 . . . . . . 0 .
 . 1 . . 2 2 2 . 0 .
 . . . . . . . . 0 .
 . . . . . . 3 . 0 .
 . . . . . . 3 . . .
 . . . . 4 . 3 . . .
 . . . . 4 . 3 . . .
 . . . . . . S . . .
