 . . . . . 3 . . . .
 . . . . . . 3 . . M
 . 0 . 0 . . . 3 . .
 . . 0 . . . . . . .
 . . 0 0 S . . . . .
 . . 0 . . . . . . .
 2 . . . . . 1 . . .
 . 2 . . . 1 . 1 . .
 . . 2 . . . 1 . . .
 . . . . . . . . 4 4
