 . . . . . . . M . .
 . 0 0 0 0 0 . . . .
 . . . . . . . . 2 .
 3 . . . . . . . 2 .
 3 . . . . . . . 2 .
 3 . 1 1 1 1 . 2 . S
 . . . . . . . . . .
 . . . . . . . . . .
 . . . . . . 4 4 . .
 . . . . . . . . . .
