 . . . . 2 . 3 3 3 .
 . . . 2 2 . . . . .
 . M . . 2 . . S . .
 . . . . . . . . . .
 . . 0 . . . . . . .
 . . 0 . 1 1 1 1 . .
 . . 0 . . . . . . .
 . . 0 . . . . 4 . .
 . . 0 . . . . 4 . .
 . . . . . . . . . .
