 . . . . . . . . . .
 . . . . . . . . . .
 . . . . . . . 1 1 .
 . . . . . . . 1 1 .
 . . 2 . . . . . . .
 M . 2 . . . . . . .
 . S 2 2 . . . 0 . .
 3 . . . . . 0 0 0 .
 3 . . . . . . 0 . .
 3 . . 4 4 . . . . .
