 . . 2 . . . . . . M
 . . 2 . . . . . . .
 . . 2 . . . . . 4 4
 . . . . 1 1 . . . .
 . . . . 1 1 . . . .
 . . . . . . . . . 3
 . . . . . 0 . . . 3
 . . . . 0 0 0 . . 3
 . . . . . 0 . . . 3
 . . S . . . . . . .
