 . . . 1 . . . . . .
 . . 1 1 1 1 . 4 4 .
 . . . . . . . . . .
 . 0 0 0 0 0 . . . .
 . . . . . . . . . .
 . . S . . M . . . .
 2 . . . . . . . . .
 2 . . . . . . . . .
 2 . 3 3 3 . . . . .
 . . . . . . . . . .
