 . . . . . . . . . .
 . . . . . . . . . .
 4 4 . . . . . . 0 .
 . . . 0 0 0 0 0 . .
 . 3 . . . . . . . .
 . 3 . . . . . M . .
 . 3 . 1 . . . . . .
 . . . 1 . . . . . S
 . . . 1 . . . 2 2 2
 . . . 1 . . . . . .
