 . . . 2 2 2 . . . .
 . . . . S . . . . .
 . . 0 0 0 0 0 . . .
 . . . . . . . . . .
 . . 3 . . . . . . 1
 . . 3 . . . . . 1 .
 . . 3 . . 4 . . 1 .
 . . . . . 4 . . 1 .
 . . M . . . . . 1 .
 . . . . . . . . . .
