 . . . . . . . . . .
 . 2 2 2 . . . . . .
 . . . . 2 . . . . .
 1 1 . . . . . . . .
 1 1 . . S 3 3 3 . .
 . . . . . . . . . .
 . . . . . . . 0 . .
 . . . . . . 0 0 0 .
 M . . 4 4 . . 0 . .
 . . . . . . . . . .
