 . . . . . . . . . .
 . . . . . . . . . .
 . . . . . 0 . M . .
 . . . . . 0 . . . .
 . . . . . 0 . . . .
 . . 4 4 . 0 . . . 2
 . . . . . 0 . . . 2
 S . . . . . . . . 2
 1 1 1 1 . . . 3 . .
 . . . . . 3 3 3 . .
