 . . . . . . . . S .
 . . . . . . . . . 3
 . . . . . . 0 . . 3
 1 1 . . . 0 0 0 . 3
 1 1 . . . . 0 . . .
 . . . . . . . . . .
 . 4 4 . . 2 . . . .
 . . . . . 2 . . . .
 . M . . . 2 . . . .
 . . . . . 2 . . . .
