 . . 1 1 . . . . . .
 . . 1 1 . . . 0 . S
 . . . . . . 0 0 0 .
 . . . . M . . 0 . .
 . . . . . . . . . .
 4 4 . 2 2 2 . . 3 3
 . . . . . . . . . 3
 . . . . . . . . . 3
 . . . . . . . . . .
 . . . . . . . . . .
