 . . . . . . . 3 . .
 . 1 . 1 . . . . 3 .
 1 . 1 . . . 0 . . 3
 . 1 . . . . 0 . . .
 . . . 4 . . 0 . . .
 . . . 4 . 0 . 0 . .
 . . . . . . . . . .
 . . . S 2 . . . . .
 . . . . . 2 . . . .
 . . . M . . 2 . . .
