 . . . 2 . . . . . .
 . . . 2 . . . . . .
 . . . 2 . 1 1 . . .
 . . . . . 1 1 . . .
 . . 0 . . . . . . .
 . 0 0 0 . . . . . .
 . . 0 S . . . 3 3 3
 . . . . . . . . . .
 . . . 4 4 . . . . M
 . . 4 . . . . . . .
