 . S . . . . . . . .
 . 4 4 . . . . . . .
 4 . . . . . . . . .
 . . . . . . . M . .
 . . 0 . . . . . . 3
 . 0 0 0 . . . . . 3
 . . 0 . . . . . . 3
 . . . . . 2 2 2 . .
 1 1 . . . . . . . .
 1 1 . . . . . . . .
