 . . . . 4 . . . . .
 1 1 . . 4 . . . . .
 1 1 . . . . . . . .
 1 . . . . . . . . .
 . . . . . . . . . .
 2 2 2 . . 0 . . . .
 . . . . 0 0 0 . 3 .
 . . . . . 0 . . 3 .
 M . . . . . . . 3 .
 . . . . . S . . . .
