 1 1 1 1 . 3 3 3 . .
 . . . . . . . . . .
 . . 0 0 0 0 0 . . M
 . . . . . 0 . . . .
 . . S . . . . . . .
 . . . . . . . . . .
 . . . 2 . . . . . .
 . . . 2 . . . . 4 4
 . . . 2 . . . . . .
 . . . . . . . . . .
