 . . . . 0 . . . . .
 . . . 0 0 0 . 2 2 2
 . . . . 0 . . . . .
 . . . . . . . . 3 .
 4 . . . . . . . 3 .
 4 . . . . . . . 3 .
 . . . . . . . . . .
 S . . . 1 1 . . . .
 . . . 1 1 1 . . . .
 M . . . . . . . . .
