 . . . . . . . . 1 1
 . . . . . 3 . . 1 1
 . . . . . 3 . . . .
 . . . . . 3 . . . .
 . M . . . S . . . .
 . . . . 2 2 2 . . .
 . . 4 . . . . . . .
 . 4 4 . . . 0 . . .
 . . . . . 0 0 0 . .
 . . . . . . 0 . . .
