 . . 4 . . . . . . .
 . . 4 . . . 3 3 3 .
 . . . . . . . . . .
 . . . . . . . . . .
 . . . 0 . . . . . .
 . . 0 0 0 . . . . 1
 . . . 0 . . . 1 1 .
 S . . . . . . 1 1 .
 . . . . . . . . . .
 2 2 2 . . . . M . .
