 . . . 1 . . 3 . . .
 . . 1 . 1 . . 3 . .
 . . . 1 . . . . 3 .
 . M . . . . . . . .
 . . . . . 0 . 4 4 .
 . . 0 0 0 . . . . .
 . . . . S 0 . . . .
 . . 2 . . . 0 . . .
 . . . 2 . . . . . .
 . . . . 2 . . . . .
