 . . . . . 2 2 2 . .
 . . . . . . . . . S
 . 3 3 3 . . . 0 . .
 . . . . . . . 0 . .
 . . . . . . . 0 . .
 . M . . . . . 0 . .
 . . . . . . . 0 . .
 . . . . . . . . . .
 . . . . . . . . . .
 . 1 1 1 1 . 4 4 4 .
