 M . . . 2 . . . . .
 . . . 2 . . . . . .
 . . 2 . . . . 3 . .
 . . . . . . . . 3 .
 . . 0 . 0 . . . . 3
 . . . 0 . . . 1 . .
 . . . 0 . . 1 1 1 .
 S . . 0 . . . 1 . .
 . . . . . . . . . .
 . . 4 4 . . . . . .
