 . 4 4 . . . . . . .
 . 4 . . . 3 3 3 . .
 . . . M . . . . . .
 . . . . . . . . . .
 2 . . . 1 1 . . . .
 2 . . . 1 1 . . S .
 2 . . . . . . . . .
 . . . . . . 0 . . .
 . . . . . 0 0 0 . .
 . . . . . . 0 . . .
