 . . . . . . . . . .
 . . . 0 . . . . S .
 . . . 0 . 2 2 2 . .
 . . . 0 . . . . . .
 3 3 . 0 . . . . M .
 . 3 . 0 . . . . . .
 . 3 . . . . 4 . . .
 . . . . . . 4 . . .
 . . . . . . . . . .
 1 1 1 1 . . . . . .
