 . . 3 . . 4 . . M .
 . . 3 . . 4 . . . .
 . . 3 . . S . . . .
 . 3 . . . . . . . .
 . . . . . . . . . .
 . . . . . . 2 . 1 1
 . 0 . . . . 2 . 1 1
 0 0 0 . . . 2 . . .
 . 0 . . . . . . . .
 . . . . . . . . . .
