 . . 3 3 3 . . 1 . .
 . . . . . . . 1 . .
 . . . . 4 4 . 1 . .
 . . . . . . . 1 . 0
 . . . . . . . . . 0
 . . . . . . . . . 0
 M . . . . . . . . 0
 . . . . . . . . . 0
 . . . . 2 2 2 . . .
 . . . . . . 2 . . S
