 . . . . . . . 3 . .
 . . . . . . . 3 . .
 . 1 1 . . . . 3 . .
 . 1 1 . . . . . . .
 . . . . . . . . . .
 . . . . . . S . . .
 M . . . . . . . . 2
 . . 0 . . 4 . . . 2
 . 0 0 0 . 4 . . . 2
 . . 0 . . . . . . 2
