 . . . . . M . . . 4
 . . . . . . . 2 . 4
 . . 1 . . . 2 . . 4
 . 1 S 1 . 2 . . . .
 . . 1 . . . . . . 0
 . . . . . . 0 0 0 .
 . . . . . . . . . 0
 . . . . 3 . . . . .
 . . . 3 . . . . . .
 . . 3 . . . . . . .
