 . . . 2 . . . . . .
 . . . 2 . . . . . .
 . . . 2 . . . 0 . .
 3 . . . . . 0 0 0 .
 3 . . . . . . 0 . .
 3 . . . S . . . . .
 . . . . . . . . . .
 . 1 1 . . . 4 4 4 .
 . 1 1 . . . . . . .
 . . . . . . . . M .
