 . . . 3 . . . 1 . .
 . . . 3 . . . 1 1 .
 . . . 3 . . . 1 1 .
 . . . . . . . . . .
 M . 2 2 2 . . . . .
 . . . . . . . . . .
 . . . . . 0 . . 4 .
 . . . . 0 0 0 . 4 .
 . . . . . 0 . . . S
 . . . . . . . . . .
