 . . . . . . . . . .
 . . . . . . . . . .
 . . 2 . . . 1 1 . .
 . . 2 . . . 1 1 . 4
 . . 2 . . . . . . 4
 . . . . . . . . . .
 . . . . 3 . . . . .
 . 3 3 3 . . 0 . . M
 . . . S . 0 0 0 . .
 . . . . . . 0 . . .
