 . . . . . . . . . .
 . 1 . . 0 . . . 4 4
 . . 1 . 0 . . . . .
 . . 1 . 0 . . M . .
 . . 1 . 0 . . . . .
 . . 1 . 0 . . . . .
 . . . . . . . . . .
 . 2 . . . . . . . .
 . 2 . 3 3 3 . . . .
 . 2 . . . S . . . .
