 . . . . . . . . . S
 . 0 . . . . . . . .
 . 0 . . 1 1 1 1 . .
 . 0 . . . . . . . .
 . 0 . . . . 3 3 3 .
 . 0 . . 2 . . . . .
 . . . . 2 . . . 4 .
 . . . . 2 . M . 4 4
 . . . . . . . . . .
 . . . . . . . . . .
