 . . . 3 . . . . . .
 . . 3 . . . . . . .
 3 3 . . . . . . . .
 . . . 4 . . . 0 . .
 . . . 4 . M . 0 . .
 . 1 . . . . . 0 . .
 1 . 1 . . . 0 . 0 .
 . 1 . . 2 . . . . .
 . . . . . 2 . . S .
 . . . . . . 2 . . .
