 M . . . . . . . . .
 . . . . . . . . . .
 . . . 0 . 0 . . 3 .
 . . . . 0 . S 3 . .
 4 4 . . 0 . 3 . . .
 . . . . 0 . . . . .
 . 2 . . . . 1 . . .
 . . 2 . . 1 . 1 . .
 . . . 2 . . 1 . . .
 . . 2 . . . . . . .
