 . . . . . . . . . .
 . 4 4 . . . 2 2 2 .
 . 4 . . . . . . . .
 . . . S . . . . . .
 M . . . 0 . . . 1 1
 . . . 0 0 0 . . 1 1
 . . . . 0 . . . . .
 . . . . . . . . . .
 . . . . . . . . . .
 . . 3 3 3 . . . . .
