 . M . . 0 . . . . .
 . . . . S 0 0 0 . .
 . . . . 0 . . . . .
 . . 1 . . . . . . .
 . 1 . 1 . . . . . .
 . . 1 . . . . . . .
 3 . . . . . . 4 4 .
 . 3 . . . 2 . . . .
 . . 3 . . . 2 . . .
 . . . . . . . 2 2 .
