 . . . . . 0 . . . .
 . . . . 0 0 0 . . .
 . . . . . 0 . . 2 .
 . . . . . . . . 2 .
 M . . . . . . . 2 .
 . . . . . . . . . 2
 3 . . . . . . . . .
 3 . . 1 1 . . . . 4
 3 . . 1 1 . . . . 4
 . . . S . . . . . .
