 . . . . 4 4 . . . S
 . . . . . . . 2 . .
 . . . 0 . . . . 2 .
 . . . . 0 0 0 . . 2
 1 . . 0 . . . . . .
 . 1 . . . . . . . .
 1 . 1 . . . . . . 3
 . 1 . . M . . . 3 .
 . . . . . . . 3 . .
 . . . . . . . . . .
