 . . . . . . . 2 . .
 . 1 . . . . 2 . . .
 1 . 1 . . 2 . . . .
 . 1 . . . . . . . M
 . . . . . . 0 . . .
 4 4 . 0 0 0 . . . .
 . . . . . . 0 . . .
 . . . 3 S . . 0 . .
 . . 3 . . . . . . .
 . 3 . . . . . . . .
