 . . . . . . . . . M
 . . 3 3 3 . . . . .
 . . 3 . . . . . 0 .
 . . . . . . . 0 0 0
 4 . . . . . . . 0 .
 4 . . . . . . . . .
 . . . . . S . . . .
 . . . . . . . . . .
 . 1 1 . 2 2 2 . . .
 . 1 1 . . . . . . .
