 . 3 3 3 . . . 2 . .
 . . . S . . 2 2 . .
 0 0 0 0 0 . . 2 . .
 . . . . . . . . . .
 . . . . . . . . . .
 . . . . . . . . . .
 . . . . . . M . . .
 1 1 1 1 . . . . . .
 . . . . . . . . . .
 . . . . . . . 4 4 .
