 . . . . . . . . . .
 . S . 1 1 . . . . .
 . . . 1 1 . . . . 2
 . . . . . . . . . 2
 . . . . . . . . . 2
 . . 3 3 3 . . . . .
 . . . . . . 4 . . .
 . . . . 0 . . 4 4 .
 . . . 0 0 0 . . . .
 . . . . 0 . . . M .
