 . . M . . . . . 1 .
 . . . . . . . 1 . .
 . . 3 . . . . 1 . .
 . . 3 . . . . 1 . .
 4 . 3 . . . . 1 . .
 4 . . . . . . . . .
 . . . . . . . . . .
 . . . . . . . 2 2 2
 . . . . . . . . . .
 0 0 0 0 0 S . . . .
