 . . 3 . . . . . . M
 . 3 . . 0 . . . . .
 3 . . . . 0 0 0 . .
 . . . . 0 . . . . 2
 . 1 . . . . . . 2 .
 1 . 1 . . . . 2 . .
 . 1 . . 4 . . 2 . .
 . . . S 4 . . . . .
 . . . . . . . . . .
 . . . . . . . . . .
