 . . . . . . . . . M
 . . . . . 2 2 2 . .
 . . . . . . . . . .
 . . . . . . 0 . . .
 . . 1 1 . 0 0 0 . .
 . . 1 1 . . 0 . . .
 . . . . . . . . . .
 . . . . . . . S . .
 . 4 . . . . . . . .
 . 4 4 . . . . 3 3 3
