 . . . . . . . . . 1
 . . . . . M . . . 1
 . . . . . . . . . 1
 . . . 0 . . . . . 1
 . . . 0 . . . S . .
 . . . 0 . . 2 . . .
 . . . 0 . . 2 2 . 3
 . . . 0 . . 2 . . 3
 . . . . . . . . . 3
 . 4 4 . . . . . . .
