 . 4 . . . . . . . .
 . 4 . . . 1 . . . .
 . . . . 1 . 1 . . 3
 . . . . . 1 . . 3 .
 . 2 . . . . . 3 . .
 . . 2 . . . . . 3 .
 . . . 2 . 0 S . . .
 . M . . . . 0 0 0 .
 . . . . . 0 . . . .
 . . . . . . . . . .
