 . . . . . . . 3 . .
 . . 1 . . . 3 . . .
 . 1 . 1 . 3 . . . .
 . . 1 . . . . . . .
 . . . . . . S 2 . .
 . . . . . . 2 . . .
 . 0 . . 2 2 . . . M
 . 0 . . . . . . . .
 . 0 . . . . . . . .
 0 . 0 . 4 4 . . . .
