 . . . . . . . . . .
 . . . . . . . . . .
 . . 2 2 2 . . . . .
 . . . . . . M . . .
 4 4 . 0 . . . . . .
 . . . 0 . 1 . . . .
 3 . . 0 . 1 . . . .
 3 . . 0 . 1 . . S .
 3 . . 0 . 1 . . . .
 . . . . . . 1 . . .
