 . . . . . . . . . 3
 . . . . . . . . 3 .
 4 4 . . . . . 3 . .
 . . . 0 . . . . . .
 . M . . 0 0 0 . . .
 . . . 0 . . . . . .
 . . . . . . . . 1 .
 S . 2 . . . . 1 . 1
 . . . 2 . . . . 1 .
 . . . . 2 . . . . 1
