 . . . . 2 . . . M .
 . . . . . 2 . . . .
 . . . . . . 2 . . .
 . . 1 S 1 . . . . .
 . 1 . 1 . . . . . .
 . . 1 . . 0 . 0 . .
 . . . . . . 0 . . .
 . . 3 . . . 0 . . .
 4 . . 3 . . 0 . . .
 4 . . . 3 . . . . .
