 . . . . . . . 0 . .
 . . . . 0 0 0 . . .
 . . . 0 . . . 0 . .
 . . . . . . . . . .
 . M . . . . . 2 . .
 . . . 1 . . . . 2 .
 . . 1 . 1 . . . . 2
 3 . . 1 . . . . . .
 . 3 . . . . . S . .
 . . 3 . . . . 4 4 .
