 . . 4 . . . . . . .
 . . 4 . . . . . . .
 . . . . . 2 2 2 . .
 . . 0 . . . . . . .
 . . 0 . . . . . . .
 . . 0 . . S . . . .
 . 0 0 . . 3 3 3 . 1
 . . 0 . . . . . . 1
 . . . . . . . . . 1
 . . M . . . . . . 1
