 . . . 2 . . . . . .
 . . 2 . . . . 1 . .
 . 2 . . . . 1 . 1 .
 . . . 3 . . . 1 . .
 S . 3 . . . . . . .
 . 3 . . . . . . . .
 . . . 0 . . . . . .
 M . . . 0 0 0 . . .
 . . . 0 0 . . . 4 .
 . . . . . . . . 4 .
