 . . . . 4 . . 0 . .
 . . . . 4 . 0 0 0 .
 . . 3 . . . . 0 . .
 M . 3 . . . S . . .
 . . 3 . . . 2 2 2 .
 . . . . . . . . . 2
 . . . . . . . . . .
 . . . . . . 1 1 . .
 . . . . . . 1 1 . .
 . . . . . . . . . .
