 . . . . . . 1 . . M
 . . . . . . 1 . . .
 . . . . 0 . 1 . . .
 . . . . 0 . 1 . . .
 . . . . 0 . . . . .
 . . . . 0 0 . . . .
 . . . . 0 . . . . .
 . . . . S . 3 3 3 .
 . . . . . . . . . .
 . 4 4 . 2 2 2 . . .
