 . . . . 1 . . . . .
 0 . . . 1 . . . . .
 0 S . . 1 . . . . .
 0 . . . 1 . . . . .
 0 . . . . . . . 4 4
 0 . . . . . . . . .
 . . . . . 3 . . . .
 . . . . . 3 . 2 2 2
 . . . . . 3 . 2 . .
 . . M . . . . . . .
