 . . 2 . . . . M . .
 . . 2 . . . . . . .
 . . 2 . . . . . 0 .
 . . . . . . . 0 0 0
 . . . . S . . . 0 .
 . . . . . . . . . .
 . 4 4 . . . . . 1 1
 . . . . . . . . 1 1
 . . . 3 . . . . . .
 . . 3 3 3 . . . . .
