 . . . . . . . . . .
 . . . S . . 3 . . .
 . . . . . . 3 . 2 .
 . . . . 4 . 3 . 2 .
 . . . . 4 . 3 . 2 .
 . . . . . . . . . .
 M . . . . . 0 . . .
 . . . . . 0 0 0 . .
 1 1 . . . . 0 . . .
 1 1 . . . . . . . .
