 . . . . . M . . . .
 2 . . 1 . . S . . .
 2 . . 1 . . 4 4 . .
 2 . . 1 . . . . . 0
 . . . 1 . . . . . 0
 . . . . . . . . . 0
 . . . . . 3 . . . 0
 . . . . 3 3 3 . . 0
 . . . . . . . . . .
 . . . . . . . . . .
