 . . . . . . . . . .
 . . . . . . . 0 . .
 . . . 0 0 0 0 . . .
 2 . . . . . . 0 . .
 . 2 . . 4 . . S . .
 . . 2 . 4 . . . 1 .
 . . . . . . . 1 . 1
 . . . . . 3 . . 1 .
 . . . . . . 3 . . .
 . . . . M . . 3 . .
