 . . . . . M . 2 . .
 . . . . . . . . 2 .
 . . 0 . 0 . . . . 2
 . . . 0 . . . . . .
 . . . 0 . . . S . .
 . . . 0 . . . . 1 .
 . . . . 0 . . 1 . 1
 3 . . . . . . . 1 .
 . 3 . . . . 4 . . .
 . . 3 . . . 4 . . .
