 . . . . . . . . . .
 . . . . . . . . . .
 . . 4 . . . 3 . . .
 . . 4 . . . 3 S M .
 . . . . . . 3 . . .
 . 0 . . . 3 . . . .
 . 0 . 1 . . . . . .
 . 0 . 1 . . 2 2 2 .
 . 0 . 1 . . . . . .
 . 0 . 1 . . . . . .
