 . . . . . . . 4 4 .
 . . . . 0 . . . . .
 2 . S . . 0 0 0 . .
 . 2 . . 0 . . . . .
 . . 2 . . . . . . .
 M . . . . . . . . .
 . . . 1 . . . . . .
 . . . . 1 . . . . 3
 . . . 1 . 1 . . 3 .
 . . . . 1 . . 3 . .
