 . . M . . . . 4 4 .
 . . . . . . . . . .
 . 0 0 0 0 0 . . . .
 . . . . . . . . . .
 . . . . . . . . . .
 . . . . . . 3 . 1 .
 . . . 2 . . 3 . 1 .
 . . . 2 . . 3 . 1 .
 . . . 2 . . . . 1 .
 . . S 2 . . . . . .
