 . . 2 . . . . . 4 4
 . . 2 . . . 3 . . .
 . 2 . . . . . 3 . .
 2 . . . . . . . 3 .
 . . . 0 . 0 . . . .
 . . . . 0 . . . 1 S
 M . . . 0 . . 1 . 1
 . . . . 0 . . . 1 .
 . . . . . . . . . .
 . . . . . . . . . .
