 . . . . . . . . . 2
 . . . . . . . 2 2 2
 3 . . M . . . . . .
 3 . . . . . 0 . . .
 3 . . . S 0 0 0 . .
 . . . . . . 0 . . .
 . . . . . . . . . .
 . 1 1 . . . . . . .
 . 1 1 . . . . . . .
 . . . . 4 4 . . . .
