 . . . M . . . 3 . .
 . . . . . . . 3 . .
 . . . . . . . 3 . .
 . . . . . 2 . . . .
 1 1 1 1 . 2 . . . .
 . . . 1 . 2 . . 0 .
 . . . . . . . . 0 .
 . . S . . . . . 0 .
 . . . . . . . . 0 .
 . . . . 4 4 . . 0 .
