 . . . . . M . . . .
 . . . . . . S . . .
 . . 3 . . 2 2 2 2 .
 . . 3 . . . . . . .
 . . 3 . 4 . . . . .
 . . . . 4 . 1 1 1 1
 . . . . . . . . . .
 . . . . . . . . . .
 . . 0 0 0 0 0 . . .
 . . . . . . . . . .
