 . . . . . . . . . .
 . . . . . . . . . .
 . . . . . . . . M .
 . . . . 0 . . . . .
 . . . 0 0 0 S . . .
 . . . . 0 . . . . .
 . . . . . . . . . .
 . 2 . 4 . 1 1 . 3 .
 . 2 . 4 . 1 1 . 3 .
 . 2 . 4 . . . . 3 .
