 . . . 4 . . . . . 2
 . . . 4 . . . . . 2
 . . . . . . . . . 2
 . 1 . . . . . . . .
 . . 1 1 . . . 0 . .
 . . 1 1 . . 0 0 0 .
 . . . . . . . 0 . .
 . . M . . . . . . .
 . . . . . . . S . .
 . . . . . . . 3 3 3
