 . . . . . . . . . .
 . . . . . . . 3 3 .
 . . . 0 . . . . 3 .
 . . 0 0 0 S . . 3 .
 . . . 0 . . . . . .
 . . . . . . . . . .
 M . . . 2 2 2 . . .
 . . . . . . . . . .
 . . . . . . 1 1 . .
 . . 4 4 . . 1 1 . .
