 . . . . . . . . 3 .
 2 2 . . . . . 3 . .
 . 2 . . . . 3 . . .
 . . 2 . . . . . . 0
 . . . . . . 0 0 0 .
 . . . 1 . S . . . 0
 . . 1 . 1 . . . . .
 . . . 1 . . . . . .
 . . . . . 4 4 . . M
 . . . . . . . . . .
