 . . . . . . . . . 0
 . . . . 3 . 0 0 0 .
 . . . 3 . . . . . 0
 . . 3 . . . 2 . . .
 . S . . . . . 2 . .
 M . . . . . . . 2 .
 . . . . . 1 . . . .
 . . . . 1 . 1 . . .
 . . . . . 1 . . . .
 . . . . . . . 4 4 4
