 . . . . . . . . . M
 . . . . . . . . . .
 . 2 . . . . . . 0 .
 . 2 . . . . . 0 0 0
 . 2 . . 1 1 . . 0 .
 . . . . 1 1 . . . 0
 . . . . . . . . . .
 3 3 3 . . . . . . .
 . . . . . . . . . .
 4 4 . . S . . . . .
