 3 . . . . 0 . . 1 .
 3 . . . . 0 . . 1 .
 3 . 2 . . 0 . . 1 .
 . . 2 . . 0 . . 1 .
 . . 2 . . 0 . . . .
 . . 2 . . . . . . .
 . . . . . . . . . 4
 . . . . . . . . . 4
 . . . . . . . . . .
 M . S . . . . . . .
