 . . . . . 4 S . . .
 . . . . . 4 . . . .
 . . . . . . . . . .
 . . . 2 . . . 0 . .
 . . 2 2 . . . 0 . .
 . . . 2 . . . 0 . .
 . . . . . . . 0 . .
 . . 1 1 1 1 . 0 . .
 . . . . . . . . . M
 3 3 3 . . . . . . .
