 . . . . . 3 3 3 . .
 . . . 2 . . . . . .
 S 1 . 2 . . . . . .
 . 1 . 2 . . . . . .
 . 1 . . . . . . . 4
 1 1 . . . . . . . 4
 . . . . . . . . . .
 . . . . . . . . . .
 . 0 0 0 0 0 . . . .
 . . . . . . . M . .
