 . . . . 1 1 1 1 S .
 . . . . 1 . . . . .
 . . . . . . . . . .
 . . . . . 0 0 0 0 0
 . . . . . . . . . .
 . . . . . . . . . .
 . . . . . . . . . .
 4 . . 3 . . . . . M
 4 . . 3 . . . . . .
 . . . 3 . . 2 2 2 .
