 . . . . . . . . . .
 . . . . 1 . . . . .
 3 . . 1 . 1 . 2 . .
 . 3 . . 1 . . . 2 2
 . . 3 . . . . . . 2
 . . . . . . . . . .
 . . . 0 . . . . . .
 . . . . 0 0 0 . . .
 M . . 0 . . . . . .
 . S . . . . . . 4 4
