 . . . . 3 . . . . .
 . . . . 3 . . . . .
 . . . . 3 . 1 1 1 1
 . . . . . . . . . .
 0 . . . . . . . S M
 0 . 2 . . . 4 . . .
 0 . 2 . . . 4 . . .
 0 . 2 . . . 4 . . .
 0 . . . . . . . . .
 . . . . . . . . . .
