 M . . 1 . . . . . .
 . . 1 . 1 . . . . .
 . . . 1 . . . . . 4
 . . . . . . . . 4 .
 . . 2 . . . . . 4 .
 . . . 2 . . . . . .
 . . . . 2 . 0 . . .
 3 . . . . S . 0 0 0
 . 3 . . . . 0 . . .
 . . 3 . . . . . . .
