 . . . . 2 . . . . .
 . . . . . 2 . . . .
 . . . 0 . . 2 . . .
 M . . 0 . . . . . .
 . . . 0 . S . . . .
 . . 0 . 0 . . 1 . .
 . . . . . . 1 . 1 .
 . . 3 . . . . 1 . .
 . 3 . . 4 4 . . . .
 3 . . . . . 4 . . .
