 . . . . . . . 0 . 0
 . . . . . . . . 0 .
 . 4 4 . . . . 0 0 .
 . . . . 2 . . . 0 .
 . 1 . . . 2 . . . .
 1 . 1 . . S 2 . . .
 . 1 . . . . . . . .
 . . . . . 3 . . . .
 . . . . . . 3 . . .
 . . . . . . . 3 . M
