 . . . . . . . . . .
 . . . . . 0 . . . .
 . . . . 0 0 0 . M .
 . . . . . 0 . . . .
 4 . . 3 S 0 . 1 1 .
 4 . . 3 . . . 1 1 .
 . . . 3 . . . . . .
 . . . . . . . . . .
 . . 2 2 2 . . . . .
 . . . . . . . . . .
