 M . . 0 . . . . . .
 . . . 0 . . . . . .
 S . . 0 . 4 . . . .
 . . . 0 . . 4 . 3 .
 . . . 0 . . 4 . 3 .
 . . . . . . . . 3 .
 . . . . 1 . . . . .
 . . . . 1 . . . 2 .
 . . . . 1 . . . 2 .
 . . . . 1 . . . 2 .
