 M . . . 1 . . . . .
 . . . 1 . 1 1 . . .
 . . . . 1 . . . . .
 . . 2 . . . . . . .
 . . . 2 . . . . . 0
 . . . . 2 . 0 0 0 .
 . 4 . . . . . . . 0
 . 4 . . . . . 3 . .
 . . . . . . 3 . . .
 . . . . . 3 S . . .
