 . . . . . . . . 4 .
 . . . . 1 . . . 4 .
 . . . 1 . 1 . . . .
 . 3 S . 1 . . . . .
 3 . 3 . . . M . . .
 . . . 3 . . . . . .
 . . . . . . . 0 . .
 . . . . 2 . . 0 . .
 . . . 2 . . . 0 . .
 . . 2 . . . 0 . 0 .
