 . . . . . . . . . .
 . . . 1 1 S . . . .
 . 3 . 1 1 . . 0 . .
 . 3 . . . . 0 0 0 .
 . 3 . . . . . 0 . .
 . . . . . . . . . .
 . . . . . . . . . .
 . . . 2 2 2 . 4 . .
 . . . . . . . 4 4 .
 . . . . M . . . . .
