 . . . . . . . . . .
 . . . 0 . . . . . .
 0 0 0 . . . . . 1 .
 . . . 0 . . . 1 . 1
 . . . . . . . . 1 .
 M . . . . . . . . .
 . . . . 4 . 2 . . .
 . 3 . . 4 . . 2 S .
 . . 3 . . 4 . . 2 .
 . . . 3 . . . . . .
