 . . 3 . S . 0 . . .
 . . 3 . . 0 0 0 . .
 . . 3 . . . 0 . . .
 . . . . . . . . . .
 2 . 4 4 . . . . . .
 2 . . . . . . . . .
 2 . . . . . . . . .
 . . . . . . . . . .
 . . . . . . 1 1 . .
 . . . M . 1 1 1 . .
