 . . . . . . . . . S
 . . . 0 0 0 0 0 . .
 . . 0 . . . . . . M
 . . . . . . . . . .
 . . . . . . . . . .
 . 1 1 1 1 . . . . .
 . . . . . . . . 2 .
 . . . 4 4 . . . 2 .
 . . . . . . . . 2 .
 . . . 3 3 3 . . . .
