 . . . . . . . . . .
 . . 3 . . 1 . . . .
 . 3 . . 1 . 1 . S M
 3 . . . . 1 1 . . .
 . . . . . . . . . .
 . . . . 0 . 0 . . .
 . . 2 . . 0 . . . .
 . 2 . . . 0 . 4 . .
 2 . . . . 0 . 4 . .
 . . . . . . . . . .
