 . . . . . . . . . .
 . . . . . 4 . . 1 1
 M . . . . 4 . . 1 1
 . . . S . . . . . .
 . . . . . . 3 . . .
 . . . 0 . . 3 . . .
 . . 0 . . . 3 . . .
 . 0 0 0 . . . . . .
 . . 0 . . 2 2 2 . .
 . . . . . . . . . .
