 . . M . . . . . . .
 . . . . 0 0 0 0 0 .
 . . . . . . . . . .
 . . 3 3 3 . . . . .
 . . . . S . . . . .
 . . . . . 4 4 . . .
 . . . . . . . . . .
 . . . . . . . . . .
 . . . 2 . 1 1 1 1 .
 . 2 2 2 . . . . . .
