 4 . . . . . . . . .
 . 4 4 . 2 2 2 . M .
 . . . . . . S . . .
 . . . . . . . . . .
 . . . 1 . . . . 0 .
 3 . . 1 . . . . 0 .
 3 . . 1 . . . . 0 .
 3 . . 1 . . . . 0 .
 . . . . . . . . 0 .
 . . . . . . . . . .
