 . . . . . . . . . .
 . . . . . . . . 2 .
 . . . . . . . 2 . .
 . . . 1 . . 2 . . .
 . . 1 . 1 . . . . M
 . S . 1 . . . . . .
 . 0 . . . . 3 . . .
 0 . 0 0 0 . . 3 . .
 . 0 . . . . . . 3 .
 . . . . 4 4 . . . .
