 . . . . M . . 1 . .
 . . 3 . . . 1 . 1 .
 . 3 . 3 . . . 1 . .
 . . . . 3 . . . . .
 . . . . . . . 0 . .
 . . . . . . . 0 . .
 . . . . . . . 0 . .
 2 . . . . . 0 . 0 .
 . 2 S . 4 . . . . .
 . . 2 . 4 . . . . .
