 . 3 3 3 . . . . . .
 . . . . . . . . . .
 . . . . . . . . . .
 . 0 . . 2 . . . . .
 0 0 0 . . 2 2 2 . S
 . 0 . . . . . . . .
 . . . 1 1 . . . . .
 . . . 1 1 . . . . .
 . . . . . . . . . .
 . 4 4 . . . M . . .
