 . . . . . . . . . .
 . M . . 1 . . . 4 4
 . . . . . 1 . . . .
 2 . . . 1 . 1 . . .
 . 2 . . . 1 . . . .
 . . 2 . . S . 3 . .
 . . . . . . . . 3 .
 . . . . . . 0 . . 3
 . . . 0 0 0 . . . .
 . . . . . . 0 . . .
