 . . 4 4 . . . . . .
 . . 4 . . . . . . .
 . . . . . M . . . .
 . . . . . . . . 1 .
 0 . . . . . . 1 . 1
 . 0 0 0 . . . . 1 .
 0 . . . . . 2 . . .
 . . . 3 . . . 2 . .
 . . . . 3 . . . 2 .
 . . S . . 3 . . . .
