 . . . . 3 . 2 . . .
 . . . . 3 . 2 . 4 4
 . . S . 3 . 2 . . .
 . . . . . . . . . .
 . M . . . . . . 1 .
 . . . . . . . . 1 .
 . . . . . . . . 1 1
 . . . . . . . . 1 .
 . 0 0 0 0 0 . . . .
 . . . . . . . . . .
