 . . . 1 1 . . . . .
 . . . 1 1 . . . . .
 . . . . . . . . M .
 . . 4 4 . . . . . .
 . . . . . . . . . .
 . 0 . . 2 2 2 . . .
 0 0 0 . . . . . . .
 . 0 . . . 3 3 3 . .
 . . . . . . . . 3 .
 . . . . S . . . . .
