 . . . 1 . . . . . .
 . . 1 . 1 . . 0 . 0
 . . . 1 . . . . 0 .
 2 . . . . . . . 0 .
 S 2 . . . . 4 . 0 .
 . . 2 . . . 4 . . .
 . . . . 3 . . . . M
 . . . 3 . 3 . . . .
 . . . . . . 3 . . .
 . . . . . . . . . .
