 . . 1 . . . . . M .
 . 1 . 1 . . 3 . . .
 . . 1 . . . . 3 . .
 . . . . . . . . 3 .
 . . 2 . . . . . . .
 . 2 . . . . . . . 4
 2 . S . . . . . . 4
 . . . . 0 . . . . 4
 . . . . . 0 0 0 . .
 . . . . 0 . . . . .
