 . . . . . . . . . .
 M . . . S . . 4 4 .
 . . . . . 0 . . . .
 . . 0 0 0 . . 3 . .
 . . . . . 0 . . 3 .
 . . . . . 0 . . . 3
 . . 2 . . . . . . .
 . 2 . . . 1 . . . .
 2 . . . 1 . 1 . . .
 . . . . . 1 . . . .
