 . . . . . 1 1 . . .
 . . . . . 1 1 . . .
 . . . . 1 . . . S M
 . . 3 . . . . . . .
 4 . 3 . . . . . 2 .
 4 . 3 . . . . . 2 .
 . . . . . 0 . . 2 .
 . . . . 0 0 0 . . .
 . . . . . 0 . . . .
 . . . . . . . . . .
