 M . . . . . . . . .
 . . . . . . S . . .
 0 0 0 0 0 . . . . .
 . . . . . . . . . .
 . . . . . . 1 . . .
 3 3 3 . . . 1 . . 2
 . . . . 4 . 1 . . 2
 . . . . 4 . 1 . . 2
 . . . 4 . . . . . .
 . . . . . . . . . .
