 . . . . . . . . . .
 3 . . . . . . . . .
 3 . . . . . . . . .
 3 . . . S . . . . .
 . . 0 . . . 2 . . .
 . . 0 . . . 2 . . .
 1 . 0 . . . 2 . 4 .
 1 . 0 . . . . . . 4
 1 . 0 . . . . . . 4
 1 . . . . . M . . .
