 2 . . . . . . . . .
 . 2 2 2 . . . . . .
 . . . . . . . . . .
 . . 3 3 3 . S . 0 .
 . . . . . . . 0 0 0
 . M . . . . . . 0 .
 . . . . . . . . . .
 . . . 1 1 . . . 4 4
 . . . 1 1 . . . . .
 . . . . . . . . . .
