 . . . . . 0 . . . .
 . . . . 0 0 0 . . .
 . . M . . 0 . . . .
 . . . . . . . . . .
 . . . 2 2 2 . . . 4
 . . . . . . 2 . . 4
 . . . . . . . . . .
 . . . . . . . . . .
 3 3 3 . 1 1 . . . .
 S . . . 1 1 . . . .
