 . . . . . . . . 1 .
 . . . . . . . 1 . 1
 . . 3 . . . . . 1 .
 . 3 . . . . M . . .
 3 . . . 2 . . . . .
 . . . . . 2 . S . .
 . 4 4 . . . 2 . . .
 4 . . . 0 . . . . .
 . . . . . 0 0 0 . .
 . . . . 0 . . . . .
