 . . . . . . . S . .
 . . . 1 . . 2 . . .
 . . 1 . 1 . . 2 . .
 . . 1 1 . . . . 2 .
 . . . . . . . . . .
 . . . 4 . . . . 0 .
 . . . 4 . M . . 0 .
 3 . . . . . . . 0 .
 . 3 . . . . . 0 . 0
 . . 3 . . . . . . .
