 M . . . . . . . . .
 . . . 2 2 2 . . . .
 . 1 . . . . . . . S
 . 1 . . . . . . . .
 . 1 . . . . . . 0 .
 . 1 . . . . . . 0 .
 . . . 3 3 3 . . 0 .
 . . . . . . . . 0 .
 . . . . . 4 . . 0 .
 . . . . . 4 4 . . .
