 . . . . 1 . 1 . . .
 . . 3 . . 1 . 1 . .
 . 3 . . . . 1 . . .
 3 . . . . . . . . .
 S . 0 . 0 . 2 . . .
 . . . 0 . . . 2 . .
 . . . 0 . . . . 2 .
 . . . 0 . . M . . .
 . . . . . . . . . .
 . . . . . 4 4 . . .
