 . . . . 2 . 2 . . .
 . 1 . . . 2 . . . .
 1 . 1 . 2 . . . . .
 . 1 . . . . . . . .
 . . . 0 . . . . . .
 . . . . 0 0 0 . . .
 3 S . 0 . . . . . .
 . 3 . . . . . . . .
 . . 3 . . M . . . .
 . . . . . . . 4 4 .
