 M . . . . . . . . .
 . . . . . . 3 . . .
 . . 0 . 0 . . 3 . .
 4 . . 0 . . . . 3 .
 4 . . 0 . . 2 . . .
 . 4 . 0 . . . 2 . .
 . . . . . . . . 2 .
 . 1 S . . . . . . .
 1 . 1 . . . . . . .
 . 1 . . . . . . . .
