 . 1 1 1 1 . . . . .
 . . . . . . . 3 3 3
 . . 2 . . . . . . .
 . 2 . . . . . . . .
 . 2 . . . . . S . .
 . 2 . . M . 0 . . .
 . . . . . . 0 . . .
 . . . . . . 0 . . .
 . . . . . . 0 . . .
 . . 4 4 . . 0 . . .
