 . . 2 2 2 . . . . .
 . . . . . . . . . .
 . . . . . . 0 . . .
 . . . . . 0 0 0 . .
 . 4 . . . . 0 . . .
 . 4 . . . . . . . .
 . . . . . . S 1 1 .
 . . . . . . . 1 1 .
 . . M . . 3 . . . .
 . . . . 3 3 3 . . .
