 . . . . . S . . . .
 . . 2 . . . . . M .
 . 2 . . 4 . 0 . . .
 2 . . . 4 . 0 . . .
 . . . . . . 0 . . .
 . . 1 . . 0 . 0 . .
 . 1 . 1 . . . . . .
 . . 1 . . 3 . . . .
 . . . . 3 . 3 . . .
 . . . 3 . . . . . .
