 . 4 4 . . . . 2 . .
 . . 4 . . . . . 2 .
 . . . . . 3 . . . 2
 . 0 . . 3 . . M . .
 . 0 . 3 . . . . . .
 . 0 . . . . 1 . . .
 0 . 0 . . 1 . 1 . S
 . . . . . . 1 . . .
 . . . . . . . . . .
 . . . . . . . . . .
