 1 1 . . . . . . . .
 1 1 . . 0 . . . . .
 . . . 0 0 0 . . . .
 . . . . 0 . . . . .
 . . . . . . . . . .
 . 4 . 2 2 2 . M . .
 . 4 . 2 . . . . . .
 . . S . . . . . . .
 . . . . . 3 3 3 . .
 . . . . . . . . . .
