 M . . . S . . 1 . .
 . . . 2 . . 1 . 1 .
 . . . . 2 . . 1 . .
 . . . . . 2 . . 1 .
 . . . 0 . . . . . .
 0 0 0 . . . . . . .
 . . . 0 . . . . . .
 . . . . . . . 3 . .
 . 4 4 . . . 3 . . .
 . . . . . 3 . . . .
