 . 4 4 . . . 3 . . .
 . 4 . . . . 3 . . .
 . . . . . . 3 . . .
 1 1 . . . . . . 2 .
 1 1 . . 0 . . . 2 .
 . . . 0 0 0 . . 2 .
 . . S . 0 . . . . .
 . . . . . . . . . .
 . . . . . . . . . .
 . . M . . . . . . .
