 0 . . 4 4 . . . . .
 0 . . . . . . . . .
 0 . . . . 1 1 1 1 .
 0 . . M . . . . . .
 0 . . . . . . 2 . .
 . . 3 . . . . 2 . .
 . . 3 . . . . 2 . .
 . . 3 . . . 2 . . .
 . . . . . . . . . .
 . . . S . . . . . .
