 . 3 . . . . . . . .
 . . 3 . . . . . . .
 . . . 3 . . . . . 2
 . 1 . . . . . . 2 .
 . 1 . . . . . 2 . .
 1 . 1 . 0 . S . . .
 . 1 . . . 0 0 0 . .
 . . . . 0 . . . . .
 . . . . . . . . . M
 . 4 4 . . . . . . .
