 . . . . . . . M . .
 . . . 3 . . . . . .
 . . 3 . . . . . . .
 . . 3 . 1 1 1 1 S .
 . . 3 . . . . . . .
 . . . . . . . 0 . .
 . 2 2 2 . . . 0 . .
 . . . . . . . 0 . .
 . . 4 . . . . 0 . .
 . . 4 . . . . 0 . .
