 . . . . . . . . . .
 M . . . . . . . . .
 . . 0 . . . . . . .
 . 0 0 0 . . . . . .
 . . 0 . . . . 3 . .
 . . . . . . 3 3 . S
 . . . . . . . 3 . .
 . . . 2 2 2 . . . .
 4 . . . . . . 1 1 .
 4 . . . . . . 1 1 .
