 . . . . . 0 . . . M
 . . . . 0 0 0 0 . .
 4 4 . . . 0 . . . .
 . . . . . . . . . .
 . . . S . . 2 2 2 .
 . . . . . . . . . .
 . . . . . . . . . .
 1 1 . . . . . 3 3 3
 1 1 . . . . . . . .
 . . . . . . . . . .
