 4 . . . . . . . . .
 4 . . . . . . . . .
 . . . . . . . 1 . .
 . . 3 . . . 1 . 1 .
 . . . 3 . . . 1 . .
 . 0 . . 3 . . . . .
 . 0 . S . . . . . 2
 . . 0 0 0 . . . 2 .
 . 0 . . . . . 2 . .
 . . . . M . . . . .
