 . . . . 0 . . . . .
 . . . 0 0 0 . . . .
 . 4 . . 0 . . . . .
 . 4 4 . . . . . . .
 . . . . . . . . . .
 . 3 3 3 . 2 2 2 . .
 . . . . . . . . . .
 . . . . . . . S . .
 . . . . . 1 1 . . .
 . . . . . 1 1 . M .
