 . . . . . . . 4 . .
 . . 1 1 1 1 . 4 . .
 . . . . . . . . . S
 . . M . . . . . . .
 . . . . . . . . . .
 . . . . . . . . . 2
 0 0 0 0 0 . 3 . . 2
 . . . . . . 3 . . 2
 . . . . . . 3 3 . .
 . . . . . . . . . .
