 . . . . . . . . . .
 . . . 2 2 2 . . . .
 . . . . . . . . . .
 . . . 0 . . 3 . . .
 . . 0 0 0 S 3 . . .
 . . . 0 . . 3 . 1 1
 . M . . . . . . 1 1
 . . . . . . . . . .
 . . . . . . 4 4 . .
 . . . . . . 4 . . .
