 . . . . . . . . . .
 . . . . M . . . 0 .
 S 4 4 . . . . 0 0 0
 . . . . . . . . 0 .
 . . . . . 1 . . . .
 . 2 . . 1 1 . . . .
 . 2 . . 1 1 . . . .
 . 2 . . . . . . 3 .
 . . . . . . . . 3 .
 . . . . . . . . 3 .
