 . . . 2 . . . . . 3
 . 4 . . 2 . . 3 3 .
 . 4 . . . 2 . 3 . .
 . . . . . . . . . .
 . . . . . . 1 . . .
 0 . . . . 1 . 1 . .
 S 0 0 0 . . 1 . . .
 0 . . . . . . . . .
 . . . . . . . M . .
 . . . . . . . . . .
