 . . . . . . 4 . . .
 . 0 . . . . 4 . . 3
 0 0 0 . . . S . . 3
 . 0 . . . . . . . 3
 . . . . . . . . . .
 . . 1 1 . M . . . .
 . . 1 1 . . . . . .
 . . . . . . . . 2 .
 . . . . . . . 2 2 2
 . . . . . . . . . .
