 . 4 . . 1 . . 2 S .
 . 4 . 1 . 1 . . 2 .
 . . . . 1 . . . . 2
 . 0 . . . . . . . .
 . 0 . . . . . . . .
 . . 0 0 0 . . . M .
 . 0 . . . . . . . .
 . . . . . . 3 . . .
 . . . . . . . 3 . .
 . . . . . . . . 3 .
