 . . . 0 . . . . . .
 . . 0 0 0 . . . . .
 . . . 0 . . . . 1 1
 . . . . . . . . 1 1
 M . . . . 4 . . . S
 . . . . . 4 . . . .
 3 . . . . . . . . .
 . 3 . . . . . . . .
 . 3 . . . . . . . .
 . 3 . 2 2 2 . . . .
