 . . . . . . . . . .
 . . . 2 2 2 . . . .
 . . . . . . . . 4 .
 . S . 1 1 1 1 . 4 4
 . . . . . . . . . .
 . . . . . . . . . .
 . . . . . . . . M .
 . . 0 0 0 0 0 . . .
 . . . . . . . . . .
 . . . . . 3 3 3 . .
