 4 . . . . . . . 1 .
 4 . . . . . . 1 1 1
 . . . 2 . . . . 1 .
 . . . . 2 . . . . .
 . . . . . 2 . M . .
 3 . . . . . . . . .
 . 3 . . . 0 . . S .
 . . 3 . . . 0 0 0 .
 . . . . . 0 . . . .
 . . . . . . . . . .
