 . . . . 0 0 0 0 0 .
 . . . . . . S . . .
 . . . . . . . . . .
 . . . 4 4 . . 3 3 3
 . . . 4 . . . . . .
 . . . . . . . . . .
 . . . . . . . . . .
 . . M . . . 1 1 1 1
 . . . . . . . . . .
 . . . . . 2 2 2 . .
