 . 4 S . . M . . . .
 . 4 . . . . . . 2 .
 . . . 0 . . . 2 . .
 0 0 0 . . . 2 . 2 .
 . . . 0 . . . . . .
 . . . . . . . . . .
 . . 1 . . . . . . .
 . 1 . 1 . 3 . . . .
 . . 1 . . . 3 . . .
 . . . . . . . 3 . .
