 . . 1 . 1 . . . . .
 . 1 . 1 . . . . . .
 . . 1 . . . . . . .
 . . . . 0 . . . . .
 . 0 0 0 . . . . . 2
 . . . . 0 . . . 2 .
 . . S . . . . 2 . .
 M . . 3 . 4 . . . .
 . . 3 . . 4 . . . .
 . 3 . . . . . . . .
