 . . . . . 4 4 . M .
 . . . . . . . . . .
 . . . . . 0 . 0 . .
 . . S . . . 0 . . .
 . . . 1 . . 0 . . .
 . . 1 . 1 . 0 . . .
 3 . . 1 . . . . . .
 . 3 . . . . 2 . . .
 . . 3 . . . . 2 . 2
 . . . . . . . . 2 .
