 . 3 . . . . . . . .
 . . 3 . . . 4 4 4 .
 . . . 3 . . . . . .
 . . . . . . S . . .
 . . . 0 . 0 . . 2 .
 . . . . 0 . . 2 . .
 . . . . 0 . 2 . . M
 . 1 . . 0 . . . . .
 1 . 1 . . . . . . .
 . 1 . . . . . . . .
