 . . 2 2 2 . . . . .
 4 . . . . . . . . .
 4 . . . . . . . . .
 . . . . . . . . . .
 . M . . . S 0 . . .
 . . . . 1 . 0 . . .
 . . . . 1 . 0 . . .
 . . 3 . 1 . 0 . . .
 . . 3 . 1 . 0 . . .
 . . 3 . . . . 0 . .
