 . . 3 3 3 . . . . .
 . . . . . . 0 . 4 4
 . . . . . . 0 . 4 .
 . . . . . . 0 . . .
 . . . . . . 0 . M .
 2 . . . . . 0 . . .
 2 . . . . . . . . .
 2 . . . . . . . . .
 S . . . . . . . . .
 . . . . 1 1 1 1 . .
