 3 3 . . . 0 . . . .
 . . 3 . . . 0 0 0 .
 . . . 3 . 0 . . . .
 . . . . . . . . . .
 2 . . . . . . . . .
 . 2 . . . . . . . .
 . S 2 . . 1 . . . .
 . . . . 1 . 1 . . .
 . . . . . 1 . . . 4
 . . . . . . . M . 4
