 M . . . . 4 4 . . .
 . . . . 4 . . . . .
 . . . . . . . 3 . .
 . . 0 . . . . 3 . .
 . 0 0 0 . . . 3 . S
 . . 0 . . . . . . .
 . . . . . . . . . .
 1 1 . . . . . . . .
 1 1 . . . 2 2 2 . .
 . . . . . . . . . .
