 . . . S . . 3 . . 2
 . 1 . . . 3 . . 2 .
 1 . 1 . 3 . . 2 . .
 . 1 . . . . . . . .
 . . . . . . . . . .
 . . . . . . . . . .
 . . 4 . . . . . . .
 . . 4 . 0 . . . . .
 . . . . 0 0 0 0 . .
 M . . . 0 . . . . .
