 . . . 3 S . M . . .
 . . 3 . 3 . . . . 2
 . . . . . 3 . . 2 .
 . . . . . . . 2 . .
 . 0 . . . . . . . .
 . 0 . . . . . . . .
 . 0 . . . . . . 1 .
 0 . 0 . . 4 . 1 . 1
 . . . . . 4 . . 1 .
 . . . . . . . . . .
