 . . . . . . . 4 . .
 . 1 1 1 1 . . 4 . .
 . . . . 1 . . . . .
 . 3 . . . . . . . .
 . 3 . . . . . . . .
 . 3 . . . . 2 2 2 .
 . . . . . . . . . .
 . . . . 0 0 0 0 0 .
 . . . . . . . . S .
 M . . . . . . . . .
