 . . . . . . . . 3 .
 . . . . . . . 3 . .
 . . . . . S 3 . . .
 . . 0 . 0 . . . 1 .
 . 0 . 0 . . . 1 . 1
 . . . 0 . . . . 1 .
 . 4 . 0 . . 2 . . .
 . 4 . . . . . 2 . .
 . . . M . . . . 2 .
 . . . . . . . . . .
