 . . . . . . . . . .
 3 3 3 . . . . . . .
 . . . . . 0 . . . .
 . . . . 0 0 0 . . .
 . . . . . 0 . . 2 .
 . 4 4 . . . . . 2 .
 4 . . . . . . . 2 .
 . . . . . . . . . .
 1 1 . . . . S M . .
 1 1 . . . . . . . .
