 . . 1 1 . . . . . M
 . . 1 1 . . . . . .
 . . . . . . . 3 3 3
 4 4 S . . . . . . .
 . . . . . . . 0 0 .
 . . . . . 2 . 0 0 0
 . . . . . 2 . . 0 .
 . . . . . 2 . . . .
 . . . . . . . . . .
 . . . . . . . . . .
