 . . . . . . 1 . . .
 . . 3 . . 1 . 1 . .
 . 3 S . . . 1 . . .
 3 . . . . . . . . .
 . . . . . . . 4 4 .
 . 0 . 0 . . . . . .
 . . 0 . . . 2 . . .
 . . 0 . . . . 2 . .
 . . 0 . . M . . 2 .
 . . . . . . . 2 . .
