 . . 4 . . . . . . .
 . . 4 . . . 3 . . .
 . . 4 . . . . 3 . .
 . . . . . 2 . . 3 .
 . 0 . . 2 . . . . .
 . 0 . 2 . . . . . .
 . 0 . . S . . 1 . .
 0 . 0 . . . 1 . 1 .
 . . . . . . . 1 . .
 . M . . . . . . . .
