 . . . 3 . . 2 2 2 .
 . . . 3 . . . . . .
 . . . 3 . . . . . .
 . . . . . . . . . .
 . . . . . . . M S 0
 . . . . . . . . . 0
 . . . . . . . . . 0
 . 1 1 1 1 . . . . 0
 . . . . . . . . . 0
 . . . . 4 4 . . . 0
