 . . . . . . . 3 . .
 . S . 4 4 . . . 3 3
 . . . . . . 2 . . 3
 . M . . 1 . . 2 . .
 . . . 1 . 1 . . 2 .
 . . . . 1 . . . . .
 . . . . . . . . . .
 . 0 . . . . . . . .
 . . 0 0 0 . . . . .
 . 0 . . . . . . . .
