 . . . . . . . . . .
 . 3 3 3 . . . . . .
 . . . . . . . . . .
 . . . . . . . 2 . .
 . . . 0 . . . 2 . 4
 . . 0 0 0 . . 2 . 4
 . . . 0 . . . . . 4
 . . . . . . 1 1 . .
 . . . . . . 1 1 . .
 . . . . M . S . . .
