 . . . . . . . . . .
 . 1 . S . . . . 2 .
 1 . 1 . . . . 2 . .
 . 1 . . 0 . 2 . . .
 . . 1 . 0 . . . . .
 . . . . 0 . . . . .
 . . . 0 . 0 . . . .
 M . . . . . . . . 3
 . . . 4 4 . . . 3 .
 . . . . . . . 3 . .
