 . . . . 2 . . . . .
 . . 1 . . 2 . . . .
 . 1 . 1 . . 2 . . .
 . . 1 . . . . 2 . .
 3 . . . M . . . . .
 . 3 . . . . . . . .
 . . 3 . . . . 0 . .
 . . S . 0 0 0 . . .
 . . . . . . . 0 . .
 4 4 . . . . . . . .
