 . . . . 3 S . . . .
 . . . 3 . . . . 1 .
 . . 3 . . . . 1 . 1
 . . . . . . . . 1 .
 . . . 0 . . . . . .
 M . . 0 . . . . . .
 . . . 0 . 0 . . . 2
 . . 0 . 0 . . . 2 .
 4 . . . . . . 2 . .
 4 . . . . . . . . .
