 . . . . . . . . . .
 . . . 2 . . . . . .
 1 . . 2 2 . M . . .
 1 . . 2 . . . . . .
 1 . . . . 3 . . . .
 1 . . 0 . 3 . . . .
 . . . 0 . 3 . . . .
 . 4 . 0 . . . . . .
 . 4 . 0 . . . . . .
 . . . 0 . S . . . .
