 . . . . . . . . . S
 . . . . . 2 2 2 . .
 . . . . . 2 . . . .
 . . . . . . . . . .
 . . 4 . . . . . 0 .
 . . 4 . . . . 0 0 0
 . . . . . . . . 0 .
 . . . . . . . . . .
 . 3 3 3 . . 1 1 . M
 . . . . . . 1 1 . .
