 . . . 0 . . . 1 . .
 . . . 0 . . . 1 . .
 . . . 0 . . . 1 . .
 . S . 0 . . . 1 . .
 . . . 0 . . . . . .
 . . . . . . . . . .
 . 4 . . . 3 3 3 . .
 . 4 . . . . . . . .
 . . . . . 2 . . . .
 . . 2 2 2 . . . M .
