 . S 0 . 2 2 2 . . .
 . 0 0 . . . . . . .
 . . 0 . . . . M . .
 . . 0 . . . . . . .
 . . 0 . . . . . . .
 . . . . . . . . . .
 . . . . 1 . . 4 . .
 . . . . 1 . . 4 . .
 3 3 3 . 1 . . . . .
 . . . . 1 . . . . .
