 . . . 2 . . . . . .
 . . 2 . . . . . . S
 . 2 . . . . . . . .
 . . . . . . . . M .
 . 0 . . . . . . . .
 . . 0 0 0 . . . . .
 . 0 . . . . 1 . 1 .
 . . . 3 . . . 1 . 1
 . . . . 3 . . . 1 .
 4 4 . . . 3 . . . .
