 . . . . . . . . . .
 4 4 . . . . . 1 1 .
 . . . . . . . 1 . .
 . . . 2 2 2 . 1 . .
 . . . . . . . 1 . .
 . . . . . S . . . .
 . . . . . . . . . .
 3 . . . . . . . . .
 3 . . M . 0 0 0 0 0
 3 . . . . . . . . .
