 2 . . . . 1 . . . .
 S 2 2 2 . 1 . 0 . .
 . . . . . 1 . 0 . .
 . . . . . 1 . 0 . .
 . . . . . . . 0 . M
 . . . . . . . 0 . .
 . . . . . . . . . .
 . . . . . . . 3 . .
 . . 4 4 . . . 3 . .
 . . . . . . . 3 . .
