 M . . . . . 3 . . .
 . . 1 . . . . 3 . .
 . 1 . 1 . . . . 3 .
 . . 1 . . 0 . . . .
 . . . . . 0 . . . .
 . . 0 0 0 . . . . .
 . . . . . 0 . 2 . .
 . . . . . . . . 2 .
 4 . S . . . . . . 2
 4 . . . . . . . . .
