 4 4 . . . . 3 . . .
 . . . . . 3 . . 1 .
 . . . . 3 S . 1 . 1
 . . . . . . . . 1 .
 . . . 0 . . . . . .
 . . . 0 . . M . . .
 . . . 0 . . . . . .
 . . 0 . 0 . . 2 . .
 . 0 . . . . . . 2 .
 . . . . . . . . . 2
