 . . 0 0 0 0 0 . . .
 . . . . . . . . . .
 . . . . 4 4 . . . .
 . . . . . . . . . 3
 . 1 . . . . . S . 3
 . 1 . . 2 2 2 . . 3
 . 1 . . . . . . . .
 . 1 . . . . . . . .
 . 1 . . . . . . . .
 . . . . . . . M . .
