 . . . . 3 . . . . .
 . . . 3 . . 1 . . .
 . . 3 . . 1 . 1 . .
 . . . S . . 1 . . .
 M . 0 . . . . . . .
 . . 0 . . . 4 4 . .
 . . 0 . . . . . . .
 . 0 . 0 . 2 . . . .
 . . . . . . 2 . . .
 . . . . . . . 2 2 .
