 . . . . . 4 . . . .
 . . . . . 4 . . . .
 . 2 2 2 . . . . . 3
 . . . . . . . . . 3
 . . . . . . 0 . . 3
 . . . 0 0 0 0 0 . .
 . . S . . . . . . .
 . . . . . . . . M .
 . . . . . . . . . .
 . 1 1 1 1 . . . . .
