 . 1 1 . . . . . S .
 . 1 1 . . . . . 4 4
 . . . . . . . . . .
 . . . . . . . . . M
 . . . . . . . . . .
 . . . . . 2 2 . . .
 . . 0 . . 2 . . . 3
 . 0 0 0 . 2 . . . 3
 . . 0 . . . . . . 3
 . . . . . . . . . .
