 . . . . . . . . 2 .
 . S . . 3 3 3 . 2 .
 . . . . . . . . 2 .
 . 0 . . . . . . . .
 0 0 0 . . . . . . .
 . 0 . . . . . . . .
 . . . . . . . . . .
 . . . M . 1 1 . . .
 . . . . . 1 1 . . .
 . . 4 4 . . . 1 . .
