 . . . . . . . . 0 .
 . . . . . . . 0 0 0
 . . . . 3 . . . 0 .
 . . . . . 3 . . . .
 . 1 1 . . 3 . . . 4
 . 1 1 . . 3 . S . 4
 . . . . . . . . . .
 . . . M . . . 2 . .
 . . . . . . . 2 . .
 . . . . . . . 2 . .
