 . . . . . . . 4 4 .
 2 2 . . . . . . S .
 2 . . . . . . . . .
 2 . . . . . 0 . . 3
 . . . . . . 0 . . 3
 . . . . . . 0 . . 3
 . . 1 . . . 0 . . .
 . . 1 . M . 0 . . .
 . . 1 . . . . . . .
 . . 1 . . . . . . .
