 . . . . . . . 4 4 .
 . . . . . . . . . .
 . . . 0 . . . . . .
 . . . 0 . . M . . .
 . . . 0 S . . . . .
 1 . . 0 . 3 . . . 2
 1 . . 0 . 3 . . . 2
 1 . . 0 . 3 . . . 2
 1 . . . . . . . . .
 . . . . . . . . . .
