 . . . . . . . . . .
 . . . 4 4 4 . . . .
 . . . . . . . 2 2 2
 . 1 1 1 1 . . . . .
 . . . . . . . S . 3
 . . . M . . . . . 3
 . . . . . . . . . 3
 . . . . . . . . . .
 . . . . 0 0 0 0 0 .
 . . . . . . . . . .
