 . . . . 0 . . . . .
 . . . 0 0 0 . . . .
 . . . . 0 . . . . .
 4 . . . . . . . . .
 4 . . . . . . 2 2 2
 . . . . . . . . . .
 . . . . . . . . . .
 S . . 3 3 3 . . . .
 . M . . 3 . . . 1 1
 . . . . . . . . 1 1
