 . . . . . . 1 1 1 1
 . . . . . . . S . .
 2 . . . . M . . . 3
 2 . . . . . . . 3 3
 2 . . . . . . . . 3
 . . . . . . . . . .
 . . . 0 0 0 0 0 . .
 . . . . . . . . . .
 . . . . . . 4 . . .
 . . . . . . 4 . . .
