 . . . . S . 0 . . .
 . . . . . . 0 . . .
 2 2 2 . . 0 0 0 . .
 . . . . . . 0 . . .
 . . . . . . . . . .
 . . . 1 1 . . . . .
 . . . 1 1 . . 3 3 3
 . . . . . . . . . .
 4 4 . . . . . . . .
 . . . . M . . . . .
