 . . . . . 3 . . . .
 . . . . . 3 . . 4 4
 . . . . . 3 . . . .
 . . . . . . . . 0 .
 . . 2 2 2 . . . 0 .
 S . . . . . . . 0 .
 . . . M . . . . 0 .
 . . . . . . . 0 0 .
 . . . . . . . . . .
 . . . . . . 1 1 1 1
