 . . . . 3 3 3 . . .
 . . . . . . . . . .
 S . 1 1 . . M . . .
 . . 1 1 . . . . . .
 . . . . . . . 4 . .
 . . . . . . . 4 . .
 . 0 . . . . . . . .
 0 0 0 . . . . . . .
 . 0 . . 2 2 2 2 . .
 . . . . . . . . . .
