 . . . . . 2 2 . . M
 . . . . . . . 2 . .
 . . . . . 3 . . 2 .
 . S . . 3 . . . . .
 . . . 3 . . . . . .
 . . . . . 1 . . 0 .
 . . . . 1 . 1 . 0 .
 . . 4 . . 1 . . 0 .
 . . 4 . . . . 0 . 0
 . . . . . . . . . .
