 M . . . . . . . . .
 . . 1 . . . . 3 3 3
 . . 1 . . . . . . S
 4 . 1 . . . . . . .
 4 . 1 . . . 0 . . .
 . . . . . . 0 . . .
 . . . . . 0 0 . . .
 . . . . . . 0 . . .
 2 2 2 . . . 0 . . .
 . . . . . . . . . .
