 M . . . 0 . . . . .
 . . . . 0 . . . . .
 . . . . 0 . . . . .
 4 4 . . 0 . . . . .
 . . . . 0 . . . . .
 . . 3 . . . . 2 . .
 . . 3 . 1 1 . 2 . .
 . . 3 . 1 . . 2 . .
 . . . . 1 . . . S .
 . . . . 1 . . . . .
