 . 1 . . . . . . . .
 1 . 1 . . 0 . 0 . .
 . 1 . . . . 0 . . .
 . . . . . . 0 . . .
 . . . S . . 0 . . M
 . . 3 . . . . . . .
 . 3 . . . 2 . . 4 4
 3 . . . . 2 2 . . .
 . . . . . . . 2 . .
 . . . . . . . . . .
