 M . . . . 0 . . . .
 . . . . . . 0 0 0 .
 . . . . . 0 . . . .
 . . 1 . . . . . . 4
 . 1 . 1 . . . . 4 4
 . . 1 . . . . . . .
 . . . . . 2 . . . S
 3 . . . . . 2 . . .
 . 3 . . . . . 2 . .
 . . 3 . . . . . . .
