 . S . . . 1 . . . .
 . 3 . . 1 . 1 . . .
 . . 3 . . 1 . . . .
 . . . 3 . . . 4 4 .
 . . . . . . . . . .
 . . M . 0 . . . 2 .
 . . . . 0 . . 2 . .
 . . . . 0 . . . 2 .
 . . . 0 . 0 . . . 2
 . . . . . . . . . .
