 . . 3 . . . . . . .
 . . 3 . . . . . . .
 . . 3 . . 2 . . . .
 . . . . . 2 . . . .
 . . . . . 2 . . . .
 . . . . . . 2 . M .
 . 1 1 1 1 . . . . .
 . . . . . . . 4 4 .
 0 0 0 0 0 S . . . .
 . . . . . . . . . .
