 . 3 3 . . . . . . .
 . 3 . . 1 . . . . .
 3 . . 1 . 1 . 4 . .
 . . . . 1 . . 4 . M
 . . . . . . . . S .
 . . . . . . . . 0 .
 . . . . . 0 0 0 . .
 . 2 . . . . . . 0 .
 . . 2 . . . . . . .
 . . . 2 . . . . . .
