 . . 3 . . . . . . M
 . 3 . . 0 . . . . .
 3 . . . . 0 0 0 . .
 . . . . 0 . . . . .
 . . . . . . . . 4 .
 . . . . . 2 . . 4 .
 . . 1 . . . 2 . . .
 . 1 . 1 . . . 2 2 .
 . . 1 . . . . . . .
 . . . . . . S . . .
