 . . . S M . 1 1 1 1
 . . . . . . . . . .
 . . . . 4 4 . . . .
 . . . . 4 . . . . .
 0 . . . . . . . . .
 0 . . . . . . . 2 .
 0 . . . 3 . . . 2 .
 0 . . . 3 . . . 2 .
 0 . . . 3 . . . . .
 . . . . . . . . . .
