 . . . . . . . . . .
 . 2 . . . . . . 1 1
 . 2 . . . . . . 1 1
 . 2 . . . S . . . .
 . . . . . . 0 . . .
 . . . . . 0 0 0 . .
 . . . . . . 0 . . .
 . . 3 . 4 . . . . .
 . . 3 . 4 . . . M .
 . . 3 . 4 . . . . .
