 . . . . . . . . . .
 . . . . . 1 1 . . .
 . . 0 . . 1 1 . . .
 . . . 0 . . . . 3 .
 . . 0 0 0 . . . 3 .
 . . . 0 . . . . 3 .
 . . . . . 4 4 . . .
 2 . . . . . . . . .
 2 . . . S . . . . .
 2 . . . . . M . . .
