 2 2 2 . . . . . . .
 . . . . . . 1 1 1 1
 . . . . . . . . . .
 . . . M . 0 . . . .
 . . . . . 0 . . . .
 S . . . . 0 . . . .
 . . 3 . . 0 . . . .
 . . 3 . . 0 . . . .
 . . 3 . . . . . 4 .
 . . . . . . . 4 4 .
