 . . . . . . . . . .
 . 4 4 . . . . . 2 .
 . . . . . . . . 2 .
 . . . . . . . . 2 .
 . . 3 3 3 . . . . 2
 . . . . . . M . . .
 . . . . S . . . . .
 1 1 . . 0 . . . . .
 1 1 . 0 0 0 . . . .
 . . . . 0 . . . . .
