 . . . 4 4 . . . . .
 . . . . . . . . . M
 . . . . . . . . . .
 S . 0 0 0 0 0 . . .
 1 . . . 0 . . . . 2
 1 . . . . . . . . 2
 1 . . . . . . . . 2
 1 . . . . . . . . .
 . . 3 3 3 . . . . .
 . . . . . . . . . .
