 . . . . . . . . . .
 . . 0 . . . . . . .
 . . . 0 0 0 . 2 . .
 . . 0 . . . . . 2 .
 . . . . . . . . . 2
 4 4 . . . 1 . . . .
 4 . . . 1 . 1 . . .
 . . 3 . . 1 . . . .
 . . . 3 . S . . . .
 . . . . 3 . . . M .
