 . . . . . . 3 . . .
 . . . . . . . 3 . .
 . . . 0 . M . . 3 .
 0 0 0 . . . . . . .
 . . . 0 . . . . . .
 . 4 . . . . . . . .
 . 4 . . . . . . . .
 . . . 2 . . . 1 . .
 . . 2 . . . 1 . 1 .
 2 2 . S . . . 1 . .
