 . . . . . . . . . .
 2 . . . . . . . . .
 2 . 0 0 0 0 0 . . .
 2 . . . . . . . . .
 . . 3 . . . . . . .
 . . 3 . . . . . . .
 . . 3 . . . . . . M
 4 . 3 . 1 1 1 1 . .
 4 . . . . . . . . .
 . . . . . . . . . S
