 3 . . . 0 . . . . .
 . 3 . . . 0 0 0 . .
 . . 3 . 0 . S . . .
 . . . . . . . . . .
 . . 4 . . 2 . . . .
 . 4 . . 2 . . . . .
 . 4 . 2 . . . . 1 .
 . . . . . . . 1 . 1
 . . . . . M . . 1 .
 . . . . . . . . . .
