 . . . . . . M . . .
 . 1 . . . . . . . .
 . 1 . . . . . 2 2 2
 . 1 . . . . . S . .
 . 1 . . . . . . . .
 . . . . . . . . . .
 . . . . . . . . . .
 . . . 0 0 0 0 0 . 3
 . 4 . . . . . . . 3
 . 4 . . . . . . 3 3
