 . . . . 0 . . . . .
 . . 2 . . 0 . . . .
 . 2 . . . 0 . 4 4 .
 2 . . . . 0 . . . .
 . . . . 0 . 0 . . .
 M . . . . . . . 3 .
 . . . . . . . 3 . .
 . . . 1 . . 3 . . .
 . . 1 . 1 . . . . .
 . . . 1 . . . S . .
