 . S . . . . . 1 . .
 . 4 4 . . . . 1 . .
 . . . . 0 . . 1 . .
 . . . . 0 . . 1 . .
 . . . . 0 . . . . .
 . . . . 0 . . . . .
 . . 3 . 0 . . . . .
 . . 3 . . . . . . .
 . . 3 . . 2 2 2 . M
 . . . . . . . 2 . .
