 . . . . . . . . . .
 3 . . . . . . . . .
 3 . . 2 . . . . 0 .
 3 . . 2 . . . 0 0 0
 . . . 2 . . . . 0 .
 . M . . . . . . . .
 . . . 1 1 . . . . 4
 . . . 1 1 1 . S . 4
 . . . . . . . . . .
 . . . . . . . . . .
