 3 . . . . . . . . .
 . 3 . . . . . . . .
 . . 3 . . . 1 . . .
 S . . . . 1 . 1 . .
 . . . . . . 1 . . .
 . . . . . . . . . .
 . . 0 0 . . . 2 . .
 0 0 0 . . . 2 . . .
 . . . 0 . 2 . . . 4
 M . . . . . . . . 4
