 . . . . . . . . . .
 . . . . . . . . . 2
 . . . . . . 3 . . 2
 . . . . . . 3 . . 2
 . 1 1 1 . . 3 . . .
 . . 1 1 . . . . . .
 M . . . . . . . . .
 . . . . . . S . 0 .
 . . . . . . . 0 0 0
 . . 4 4 . . . . 0 .
