 . . 2 . . . . . . .
 . . . 2 . . . . 4 .
 3 . . . 2 . . . 4 .
 . 3 . . . . 0 . . .
 . . 3 . . 0 . 0 . .
 . . . . . . 0 . . .
 . . . 1 . . 0 . . S
 . . 1 . 1 . 0 . . .
 . . . 1 . . . . . .
 M . . . . . . . . .
