 . . . . . . 0 . . 4
 2 . . 0 0 0 . . 4 .
 . 2 . . . . 0 . 4 .
 . . 2 . . . . . S .
 . . . . . . . . . .
 . . . . . 1 . . . .
 . . . . 1 . 1 . . .
 . . 3 . . 1 . . . .
 . . . 3 . . . M . .
 . . . . 3 . . . . .
