 . . . 2 . . . . . S
 . . . 2 . . . . . .
 . . . 2 . . . 4 4 4
 . . . . . . . . . .
 . . 3 . . 1 1 1 1 .
 0 . 3 . . . . . . .
 0 . 3 . . . . . . .
 0 . . . . . . . . M
 0 . . . . . . . . .
 0 . . . . . . . . .
