 2 . . . M . . . . .
 2 . . . . . . . . .
 2 . . . . . . . . .
 . . . . . 0 . . . .
 . . . . 0 0 0 . . .
 . . . . . 0 . . 4 .
 . 1 1 . . . . . . 4
 S 1 1 . . . 3 . . 4
 . . . . . . 3 . . .
 . . . . . . 3 . . .
