 . . . 0 0 0 0 0 . .
 . . . . . . . . . .
 . . . . . . . . . .
 . . 2 2 2 . . . . .
 . . . . . . 4 . . 3
 . . 1 . . . 4 . . 3
 . . 1 . . S . . . 3
 . . 1 . . . . . 3 .
 . . 1 . . . . . . .
 . . . . M . . . . .
