 . . . M . . . . . .
 . . . . . . . . . .
 . . . 0 . 2 2 2 . .
 . . . 0 . . . . . .
 . . . 0 . . . 1 . .
 . . . 0 . . . 1 . .
 . 4 . 0 . . . 1 . .
 . 4 . . . . . 1 . .
 . S . . . 3 . . . .
 . . . . . . 3 3 3 .
