 3 . . . . . . . . S
 3 . . . . . . . 0 .
 3 . 2 . . . . . 0 .
 . . 2 . . . . . 0 .
 . . 2 . . . . . 0 .
 . . . . . . . . 0 .
 . . . . . . . . 0 .
 . . . . . . . . . .
 4 4 . . . . . . . .
 . . . . 1 1 1 1 . M
