 . . 0 0 0 0 0 . . .
 . . . . . . . . . .
 . . . . . . . M . .
 . . . . . . . . . .
 . . . . . . 1 1 1 1
 . . . . . . . . . .
 . 2 . . . . . 3 . .
 2 2 2 . . . . 3 . .
 . . . . . S . 3 . 4
 . . . . . . . . . 4
