 . . . . . . . . . .
 . 1 . . . . . . . 3
 1 . 1 S . 0 . . 3 .
 . 1 . . . 0 . 3 . .
 . . . . . 0 . . . .
 . . . . 0 . 0 . . .
 . . . 0 . . . . . .
 . . . . . . 2 . . .
 . 4 4 . . . . 2 . .
 . . . . . M . . 2 .
