 . . 3 3 3 . . . . .
 . . . . . . . . . .
 . . . . 0 0 0 0 0 .
 4 . S . . . . . . .
 . 4 4 . . . . . . .
 . . . . . . . . . .
 . . . . . . . . . .
 . . . 1 1 1 1 . . .
 . . . . . . . . . .
 . . . . 2 2 2 . M .
