 . . . 0 . . . . . .
 0 0 0 . . . . . . .
 . . . 0 . . . . 1 .
 M . . 0 . . . 1 . 1
 . . . . . . . . 1 .
 . . . . . 2 . . . .
 . . . . 2 . . . . .
 . . . 2 . . . 3 . .
 S 4 . . . . . . 3 .
 . 4 . . . . . . . 3
