 . . . . . . M . . 2
 . . . 0 . . . . 2 .
 4 . . 0 . . . 2 . .
 4 . . 0 . . . . . .
 . . 0 . 0 . . . . .
 . . . . . . . . . .
 . 3 . . . . . . . .
 S . 3 . . 1 1 . . .
 . . . 3 . 1 . 1 . .
 . . . . . . 1 . . .
