 . 3 . . . . . . . .
 . 3 3 . . . 1 1 . .
 . 3 . . . . 1 1 . .
 . . . . . . . . . .
 . . . 0 . . . . . .
 . . 0 0 0 . . . . .
 S . . 0 . . . . . .
 . . . . . . . . . .
 4 . 2 2 2 . . M . .
 4 . . . . . . . . .
