 . . . . . 1 1 1 . .
 . . . . . . 1 1 . .
 . . S . . . . . . .
 . 2 . . . . . 0 . .
 . 2 . 4 4 . 0 0 0 .
 . 2 . . . . . 0 . .
 . . . 3 . M . . . .
 . . . 3 . . . . . .
 . . . 3 . . . . . .
 . . . . . . . . . .
