 . . . . 3 . . . . .
 . 2 . . 3 . . . . .
 . 2 . . 3 . . 0 . .
 S 2 . . . . 0 0 0 .
 . . . . . . . 0 . .
 . . . . . . . . . .
 . . 1 . . . . . . .
 1 1 . . . . . . . .
 1 1 . . . . 4 . . .
 . . . M . . 4 . . .
