 4 4 . . 1 . . S . .
 . . . 1 . 1 . . . .
 . 2 . . 1 . . . . .
 . . 2 . . . . . . M
 3 . . 2 . . . . . .
 . 3 . . . . 0 . . .
 . 3 3 . . . 0 . . .
 . . . . . . 0 . . .
 . . . . . 0 . 0 . .
 . . . . . . . . . .
