 . . . . . . 4 . . .
 . . . . . . 4 . . .
 . . . . . . . . . 1
 . . . . . . . . . 1
 . 3 . . . . . . . 1
 . 3 . S 2 2 2 . . 1
 . 3 . . . . . . . 1
 . . . . . . . . . .
 . . . . . . . . . .
 . . . 0 0 0 0 0 . M
