 . . . . . 1 1 . . 0
 . 2 2 2 . . 1 . . 0
 . . . . . . 1 . . 0
 . . . . . . 1 . . 0
 . . . . . . . . . 0
 . . . . . . . . . .
 . . . . . . . . . 4
 M . . . . . . . . 4
 . . . . . . . S . .
 . . . . . 3 3 3 . .
