 . . M . . . 1 1 1 1
 . . . . . 1 . . . .
 . . . . . . . . . .
 . . S 0 0 0 0 0 . .
 . . . . . . . . . .
 . . . . . . . . . .
 . . . 3 3 3 . 4 4 .
 . . . . . . . . . .
 . . . . . . . . . .
 . . . 2 2 2 . . . .
