 . . . . . . . M . .
 2 2 2 . . . . . . .
 . . . 2 . . . . 0 .
 . . . . . . . . 0 .
 . 3 3 3 . . S . 0 .
 . . . . . . . . 0 .
 . 1 1 1 1 . . . 0 .
 . . . . . . . . . .
 . . . . . . . . . .
 . . . . . . 4 4 . .
