 . . . . . 4 . . . 0
 . . . . . 4 . 3 . 0
 . 1 . . . . . 3 . 0
 . 1 . M . . . 3 . 0
 . 1 . . . . . . . 0
 . 1 . . . . 2 . . .
 . . . . . . 2 . . .
 . . . S . . 2 . . .
 . . . . . . . 2 . .
 . . . . . . . . . .
