 . . . . . . 2 2 2 .
 . M . . 1 . . . . .
 . . . . 1 . 4 4 . S
 . . . . 1 . . . . .
 0 . . . 1 . . . . .
 0 . . . . . . 3 . .
 0 . . . . . 3 . . .
 0 . . . . . 3 . . .
 0 . . . . . 3 . . .
 . . . . . . . . . .
