 . . . . . 0 . . . .
 . . . . 0 0 0 . . .
 . . . . . 0 . . . .
 . . . . . . . . . .
 . M . . . . . 1 1 .
 . . . 2 2 2 . 1 1 .
 . . . 2 . . . . . .
 . . . . . . . 3 . .
 . 4 . . . . . 3 . .
 . 4 . . . . . 3 S .
