 . . 4 4 . . . . . .
 3 . . . . . . 0 S .
 3 3 3 . M . . 0 . .
 . . . . . . . 0 . .
 . . . . . . . 0 . .
 1 1 1 1 . . . 0 . .
 . . . . . . . . . .
 . . . . . . 2 2 2 .
 . . . . . . . . . .
 . . . . . . . . . .
