 . . 1 1 . . . . . .
 . . 1 1 . . . . . .
 . . . . . . 0 . . .
 . . . . . 0 0 0 . .
 . . . . . . 0 . . .
 . . . . . . . . . S
 . . . . . . . . . .
 4 . . . M . . . . .
 4 . 2 . . . . 3 3 3
 . . . 2 2 2 . . . .
