 . . . . S . . 3 . .
 . . . . . M . 3 . .
 . . . . . . . 3 . .
 . . 0 . . . . . . .
 . 0 0 0 . . 2 . . .
 . . 0 . . . 2 2 2 .
 . . . . . . . . . .
 . 4 . . . . . . . .
 . 4 . . 1 1 . . . .
 . . . . 1 1 . . . .
