 . . . . 3 . . . . .
 . . . . . 3 . . . .
 . . . . . . 3 . . .
 . . 2 . . . . . . .
 . 2 . . . . . 1 . .
 2 . . 0 . . 1 . 1 1
 . . . 0 . . . 1 . .
 S . . 0 . . . . . .
 . . 0 . 0 . . 4 . M
 . . . . . . . 4 . .
