 . . . . . . . . . .
 2 2 2 . . . M . . .
 . . . . 4 . . . . .
 . . . . 4 . . . . .
 3 3 3 . . . . . . .
 . . . . . . . . . .
 . . . 1 1 . . 0 . .
 . . . 1 1 S 0 0 0 .
 . . . 1 . . . 0 . .
 . . . . . . . . . .
