 . . . . . 2 . . . .
 . . . . 2 . . 3 . .
 . . . 2 . . . . 3 .
 M . . 2 . 4 . . S 3
 . . . . . 4 . . . .
 0 . . . . . . . . .
 . 0 0 0 . . . . . .
 0 . . . . . . . 1 .
 . . . . . . . 1 . 1
 . . . . . . . . 1 .
