 . . . M . . . 0 . .
 . . . . . . 0 0 0 .
 . 4 4 . . . . 0 . .
 . . . . . . . . . .
 . 2 . . . . . . . .
 2 2 2 . . . 3 3 3 S
 . . . . . . . . . .
 . . . . . . . . . .
 . 1 1 . . . . . . .
 . 1 1 . . . . . . .
