 . 4 . . . . . . 3 .
 . 4 . . . . . . . 3
 . . . 1 . . . . 3 .
 . . 1 . 1 . . 3 . .
 . . . 1 . . . . . .
 . . . . . . . . M .
 . . . 0 . . . . . .
 . . . 0 . . . . 2 .
 . . . 0 . . S 2 . .
 . . 0 . 0 . 2 . . .
