 . . . . . . . . . .
 . . 1 . . . . . 2 .
 . . 1 . . . . . 2 .
 . . 1 . 4 4 . . 2 .
 M . 1 . . . . . . .
 . . . . . . . . . .
 . . . . . . . . . .
 . 0 0 0 0 0 . . . .
 0 . . . . . . . . .
 . . . S . . . 3 3 3
