 . . . . . M . . . .
 . . . . . . . . 0 .
 . . . . . . . 0 0 0
 4 S . . . . . . 0 .
 4 . . 1 1 . . . . .
 . . . 1 1 . . . 2 .
 . . . . . . . . 2 .
 . . . . . . . . 2 .
 . . . . . . . . 2 .
 . . . . 3 3 3 . . .
