 3 3 3 . . . . . . .
 . . . . . 0 . . . .
 . . . . 0 0 0 . M .
 . . . . . 0 . . . .
 . . . . . . . . . .
 2 2 2 . . . S . . .
 2 . . . . . . . . .
 . . . . . . . . . .
 . . . 1 1 . . . . .
 4 4 . 1 1 . . . . .
