 . . . . . . . . . .
 . . . . . . . . 4 4
 . . . . . . . . . 4
 . 0 0 0 0 0 . . . .
 . . . . . . . . M .
 . 2 2 2 . . . . . .
 . . . . . . . . . .
 . . . . . . . . . .
 3 3 3 . S 1 1 1 1 .
 . . . . . . . . . .
