 . . . . . . . 0 . .
 . . . . . . . 0 . .
 2 2 2 . . . . 0 . .
 . . . . . . . 0 . .
 . 1 1 1 1 1 . 0 . .
 . . . . . . . . . .
 . . . . . . S . . .
 . . . M . . . . . 3
 . . . . . . . . . 3
 . . 4 4 . . . . . 3
