 . . . . . . . . . .
 . . . . 3 3 3 . . .
 . . . . . . . . . 2
 . . . 0 . . . . . 2
 . . 0 0 0 . M . . 2
 . . . 0 . . . . . S
 . . . . . . . . . .
 . . . . . . . . . .
 . . 1 1 . . 4 4 . .
 . . 1 1 . . 4 . . .
