 . . . . . . . . 4 4
 3 . . . . . 2 . . 4
 . 3 . . . 2 . . . .
 . . 3 . 2 . . . . .
 . . . . . . . . . .
 . 1 . . . 0 . 0 . .
 1 . 1 . . . 0 . . .
 . 1 . . . . 0 . . .
 . . . . . . 0 . . .
 . . . M . . . S . .
