 . . . . . . . . . M
 . . . . . . . . . .
 . . . 3 . . . . . .
 1 1 . 3 . . . 4 . .
 1 1 S 3 . . . 4 . .
 . . . . . . . . . .
 . . . 0 . . . 2 2 2
 . . . . 0 . . . . .
 . . . 0 0 0 . . . .
 . . . . 0 . . . . .
