 . . . M . . . . . .
 . . . . . . . 1 1 .
 . . . . 2 . . 1 1 .
 . . 3 . 2 . . . . .
 . . 3 S 2 . . . . 4
 . . 3 . . . . . . 4
 . . 3 . . . . . . .
 . . . . . . . . 0 .
 . . . . . . . 0 0 0
 . . . . . . . . 0 .
