 . . . . . S . . . .
 . . . M . . . 4 4 .
 . . . . . . . . . .
 3 . . . . 1 . . . .
 . 3 . . 1 . 1 . . .
 . . 3 . . 1 . . . 2
 . . . 3 . . . . 2 .
 0 . . . . . . 2 . .
 . 0 0 0 . . . . . .
 0 . . . . . . . . .
