 . . . 1 . . . . . .
 . . 1 . 1 . . 3 . .
 . . . 1 . . . . 3 .
 . . . . . . . . . 3
 . . . . . 0 . . . .
 . . 0 0 0 . . . . .
 . . . . . 0 . . . M
 . . 2 . S . . . . .
 . . . 2 . . . 4 4 .
 . . . . 2 . . . 4 .
