 . . . . . . . . . .
 . 0 . . . . . . . .
 0 0 0 . . . . . . 2
 . 0 . . . . . . . 2
 . . . . . . 1 . . 2
 . . . . 1 1 . . . .
 . . . . 1 1 . . . .
 4 . . . . . . . 3 .
 4 . S . . . M . 3 .
 . . . . . . . . 3 .
