 . . . . . . . . . .
 . . . . . . 1 1 1 .
 3 . 2 . . . . 1 1 .
 3 . 2 . . S . . . .
 3 . 2 . . . 0 . . .
 . . . . . 0 0 0 . .
 . . . . . . 0 . . 4
 . . . M . . . . . 4
 . . . . . . . . . .
 . . . . . . . . . .
