 M . . . . . . . . .
 . . . 3 3 3 . . . .
 . . . 3 . . . . . .
 . 4 . . . . . . . .
 . 4 . . . . . . . S
 . . . . . 1 1 1 1 .
 . . . . . . . . . .
 2 2 2 . . 0 0 0 0 0
 . . . . . . . . . .
 . . . . . . . . . .
