 3 . . . . . . . . .
 . 3 . . . 1 . . . .
 . 3 3 . 1 . 1 . 4 .
 . . . . . 1 . . 4 .
 . . . . . . . . . .
 . . . . . . 0 . S .
 . . 2 . . . . 0 0 0
 . 2 . . . . 0 . . .
 2 . . . . . . . . .
 . . . . . . M . . .
