 . . . . . S . 2 2 2
 . . . . . . . . . .
 . . . . . . . . . .
 . 0 0 0 0 0 . . . .
 . 0 . . . . . . . .
 . . . . . . . . . .
 1 1 1 1 . . . M . .
 . . . . . . . . . .
 . . . 3 3 3 . 4 4 .
 . . . . . . . . . .
