 . . . . . . . . 4 .
 . . . . . . . . 4 .
 2 2 2 . . . . . . .
 . . . . . . . . . .
 . . . . . . 3 3 3 .
 . . . 0 . . . . . .
 . . 0 0 0 . . . . .
 . . . 0 . . . . . .
 S . . . . . . . 1 1
 . . . . M . . 1 1 1
