 . . . . . . . . 1 .
 . . 0 S 0 . . 1 . 1
 . . . 0 . . . . 1 .
 . . . 0 . . . . . .
 . . . 0 . . . . . 2
 . . 0 . . . . . 2 .
 . . . . . M . 2 . .
 . 3 . . . . . . . .
 . . 3 . . . . 4 4 .
 . . . 3 . . . . . .
