 . . . . 2 . . . . .
 . . . 2 . . . . 0 .
 . . 2 . . . . . 0 .
 . . . . . . . . 0 .
 S . . 1 . . . 0 . 0
 . . 1 . 1 . . . . .
 4 . . 1 . . 3 . . .
 4 . . . . 3 . . M .
 . . . . 3 . . . . .
 . . . 3 . . . . . .
