 . . . . . . . . . 2
 . 1 . . . . . . . 2
 . 1 . . . . . . . 2
 . 1 . . . 3 3 3 . .
 . 1 . . . . . . 3 .
 . . . . . . . . . .
 . . 0 0 0 0 0 . . .
 . . . . . . . . M .
 . . . . . 4 4 . . .
 . . . . . . . . . S
