 . . . . . . . . . .
 2 . . . . . . . . .
 . 2 . . . 0 . . . .
 . . 2 . . 0 . . S .
 . . . . . 0 . . . .
 4 4 . . 0 . 0 . . .
 . . . . . . . . . .
 M . . 1 . . 3 . . .
 . . 1 . 1 . . 3 . .
 . . . 1 . . . . 3 3
