 M . S . . . . . . .
 . . . . . . . 3 . .
 . 2 . 2 . . 3 . . .
 . . 2 . . 3 . . . .
 . . . 2 . . . . 1 .
 . . . . . . . 1 . 1
 . . . . . . . . 1 .
 . . . . . 0 . . . .
 . . 0 0 0 . . . 4 .
 . . . . . 0 . . 4 .
