 . . . . . . 0 . . M
 . . . 0 0 0 . . . .
 . . . . . . 0 . . .
 . . S . . . . . . .
 . . . . . . . . . .
 . . 2 . . 1 . . 4 4
 . 2 . . 1 . 1 . . .
 2 . . . . 1 . . . 3
 . . . . 1 . . . 3 .
 . . . . . . . 3 . .
