 . . . 0 0 0 0 0 . .
 . . . . . . . . . .
 . . . . . . 4 4 . .
 . . . . . . . . . 1
 . . . . . . . . . 1
 . . . . 3 3 3 . . 1
 . . . . . . . . . 1
 . . . 2 2 . . . . .
 . . . 2 . . . S . M
 . . . 2 . . . . . .
