 . . . . . . . . . .
 . . . . 3 . . . . .
 . . . 3 . . . . . .
 . . 3 . . . . 4 4 .
 . . . . . . . 4 . .
 . 1 . . . . . . . 0
 1 . 1 . . . 0 0 0 .
 . 1 . . 2 . . . . 0
 . . . 2 . . . . S .
 . . 2 . . . . . M .
