 . . S . . 2 . . . .
 . . . . 2 2 2 . M .
 . . . . . . . . . .
 . . . . . . . . . .
 . . . . . . . . . .
 . . . . . . . . 0 .
 3 . . 1 1 . . 0 0 0
 3 . . 1 1 . . . 0 .
 3 . . . . . . . . .
 . . . . . 4 4 . . .
