 . . . . . . . . 2 .
 . . . 4 . . . . 2 .
 . . . 4 . . . . 2 .
 . . . . . . . . . .
 . . . . . . . . . 3
 . 0 . . 1 1 . . . 3
 0 0 0 . 1 1 . . . 3
 . 0 . . . . . . . .
 . 0 . S . . . . . .
 . . . . . . M . . .
