 . . . . . . . . . 4
 0 . 0 . . . . M . 4
 . 0 . . . . . . . .
 . 0 . . . 1 . 1 . .
 . 0 . . 1 . 1 . . .
 . . . . . 1 . . . .
 . . . . . . . . 3 .
 . . 2 . . . . 3 . .
 . . . 2 . . 3 . . .
 . . . . 2 . S . . .
