 . 0 . . M . . . . .
 S 0 . . . . . . . .
 . 0 . . . . . . . .
 . 0 . 1 1 1 1 . . .
 . 0 . . . . . . . .
 . . . . . . . . . .
 . . . . . . . . . 3
 . 4 4 . . 2 2 2 . 3
 . 4 . . . . . . . 3
 . . . . . . . . . .
