 . . . . . . . . . .
 . . . . . . . . . .
 . . . . . . . 1 . .
 . . . . . . . 1 . .
 . . . . 4 . . 1 . .
 3 . . . 4 . . 1 . M
 3 3 . . . . . . . .
 3 . . 0 0 0 0 0 . .
 . . . . . . . . . .
 . . S . . . 2 2 2 .
