 . . M . 2 . . . . .
 . . . . 2 . . . . .
 4 . . . 2 . . . . .
 4 . . . . . . 0 . .
 . . . . . . 0 0 0 .
 . . . . . . . 0 . .
 . . . . . . . . . .
 . . . . . . 1 1 . S
 . 3 3 3 . . 1 1 . .
 . . . . . . 1 . . .
