 . . . . . 1 1 1 1 .
 . M . . . . . . . .
 . . . . . 0 0 0 0 0
 . . . . . . . . . .
 . . . . . S . . . 3
 . . . . . . 3 3 3 .
 . . . . . . . . . .
 . . . 2 2 2 . . 4 .
 . . . . . . . . 4 .
 . . . . . . . . . .
