 . 3 . . . . . . . .
 . 3 . 1 . . . . . .
 . 3 . 1 . . . . . .
 . 3 . 1 . . . . . .
 . . . 1 . 0 0 0 0 0
 . . . . . . . . . .
 4 . . . . . . . . .
 4 . 2 . . . . . . .
 . . 2 . . . . . . S
 . . 2 . . . . M . .
