 . . . . . . . . . .
 2 . 2 . 3 . . . . .
 . 2 . . . 3 . . . .
 2 . . . . . 3 . . .
 . . . . . . . . 0 .
 . . . . . 0 0 0 . .
 . . . . . . . . 0 .
 . . S 1 . . M . . .
 . . 1 . 1 . . . . 4
 . . . 1 . . . . . 4
