 . . . . . 2 . 4 . .
 . . . . 2 . . 4 . .
 . . . 2 . . . 4 . .
 . 0 . . . . . . . .
 . . 0 0 0 . S . 1 .
 . 0 . . . . . 1 . 1
 . . . . . . . . 1 .
 . 3 . . . . M . . .
 . . 3 . . . . . . .
 . . . 3 . . . . . .
