 . . . . . 3 3 3 . .
 M . . 2 . . . . . .
 . . . 2 . . . . . .
 . . . 2 . . . . . .
 . . . 2 . . . . . .
 . . . . . . . . . .
 . . . . . . . 0 . S
 4 . . 1 1 . 0 0 0 .
 4 . . 1 1 . . 0 . .
 . . . . . . . . . .
