 . . . S . . . . . .
 . 2 2 . . . . . . .
 . . 2 . . . . . . .
 . . 2 . . . . . 1 .
 . . . . . . . . 1 .
 4 . 0 0 0 0 0 . 1 .
 4 . . . . . . . 1 .
 . . . . . . . . . .
 . . 3 3 3 . . . . .
 . . . . . . . . . M
