 . . . . . . . 1 . .
 3 . . . . . 1 . 1 .
 . 3 . . . S . 1 . .
 . . 3 . . . . . . .
 . . . . . 0 . . . .
 . . . 2 . 0 . . . .
 . . 2 . . 0 . 0 . .
 . 2 . . 0 . 0 . . .
 . . . . . . . . . .
 . 4 4 . . . . M . .
