 . . . . . . . . 3 .
 2 . . . . . . 3 . .
 . 2 . . . . 3 . . .
 . . 2 . 0 . . . . .
 . . . . . 0 0 0 . .
 . . . 0 0 . . . . .
 . . . . . . . . . .
 . . . . S 1 . . 4 4
 . M . . 1 . 1 . . .
 . . . . . 1 . . . .
