 . . . . . . M . . .
 . . . . . . . . . .
 . . . . 3 3 3 . . .
 . . . . . . . . . .
 . . . . . . . . . .
 . . 4 . . 2 2 2 . .
 . 4 . . . . . . . .
 . 4 . . 0 S . 1 1 .
 . . . 0 0 0 . 1 1 .
 . . . . 0 . . . . .
