 . . . . . . . . . .
 . 3 . . . . . . . .
 . 3 . . . . . . . .
 . 3 . 1 1 1 1 . . .
 . . . . . . . . . 0
 . . . . . . . . 0 .
 2 2 2 . . . . . 0 .
 . . . . . . . . 0 .
 4 . . . . . . . 0 .
 4 . . . M . . . 0 S
