 . . . . . . . . . .
 . . . . . . . 4 4 .
 . . . . . . . . . .
 . . 1 1 . . . . . 2
 . . 1 1 . 3 3 3 . 2
 . . . . . . . . . 2
 . . . . . . . . S .
 . . . . . . . . 0 .
 M . . . . . 0 0 0 0
 . . . . . . . . 0 .
