 . . . . . 2 . . . .
 . . . . 2 2 2 . . .
 . . . . . . . . . .
 . . . . 4 4 . 1 . .
 . . . . . . . 1 . .
 . . . 0 . . . 1 . .
 . . . 0 . M . 1 . 3
 . . . 0 S . . . . 3
 . . . 0 . . . . . 3
 . . . 0 . . . . . .
