 . . . . . . . . . .
 . . . . . S . . . .
 . . 2 2 2 . 4 4 . M
 . . . . . . . . . .
 . . . . 0 . . . . .
 . . . 0 0 0 . . . .
 . . . . 0 . . 1 1 .
 . . . . . . . 1 1 .
 . 3 3 3 . . . . 1 .
 . . . . . . . . . .
