 . . . . . . 0 . . .
 . . . 3 3 . 0 . . .
 . . 3 . . . 0 . . .
 . 3 . . . 0 . 0 . .
 . . . . . . . . . .
 . . . . S . . . . M
 . . . 1 . . . 2 . .
 . . 1 . 1 . . . 2 .
 . . . 1 . . . . . 2
 4 4 . . . . . . . .
