 . 1 1 1 . . . . . .
 . . 1 1 . . . . . .
 . . . . . . . . . .
 . . . 3 3 3 . . . .
 . . . S . . . . . .
 . . . . 0 . . M . .
 . . . 0 0 0 . . . .
 . . . . 0 . . . . .
 . . . . . . . . . 4
 . . . . 2 2 2 . . 4
