 . . . . . . . . . .
 . . . . . 0 . M . .
 . . 0 0 0 S . . . 3
 . . 0 . . 0 . . 3 .
 . . . . . . . 3 . .
 . . . . . 4 . . . .
 . . . . . 4 . . . 2
 . . . 1 . . . . 2 .
 . . 1 . 1 . . 2 . .
 . . . 1 . . . . . .
