 . . 1 . . . . . . .
 1 1 . 1 . 3 . . . M
 . . 1 . . . 3 . . .
 . . . . 2 . . 3 . .
 . . . 2 . . . . . .
 . . 2 . . . 0 . 4 4
 . . . . . . 0 . . .
 . . . . . . 0 . . .
 . . . S . 0 . 0 . .
 . . . . . . . . . .
