 . . . . 0 . . . . .
 . . . 0 0 0 . . . .
 . . . . 0 . . . . .
 1 1 . . . . . . . 2
 1 1 . . . . 3 . . 2
 . . . . . . 3 . . 2
 . . . 4 4 S 3 . . .
 . . . 4 . . . . . .
 . . . . . . . . . M
 . . . . . . . . . .
