 . . . . 0 0 0 0 0 .
 . . . . . . . . . .
 . . . . . . . . . .
 . . . . . . . . . .
 . . . . . . 4 . . .
 . . . M . . 4 . . 1
 . 2 . . . . . . . 1
 . 2 . . S . . . . 1
 . 2 . . 3 3 3 3 . 1
 . . . . . . . . . .
