 2 . . . . . . . . .
 . 2 . . . . 3 . . .
 . . 2 . . 3 . . . .
 . . . . 3 . . . . .
 . 4 4 . . . 0 . . .
 4 . . . . . 0 . . .
 . S . . . . 0 . . .
 . . 1 . . 0 . 0 . .
 . 1 . 1 . . . . . .
 . . 1 . . M . . . .
