 . . . . . . . . . .
 0 0 0 0 0 . 2 2 2 .
 . . 0 S . . . . . .
 . . . . . 4 4 . 3 .
 . . . . . . . . 3 .
 . . . . . . 1 . 3 .
 . . . . . . 1 . . .
 . . . . . . 1 . . .
 . . . . . . 1 . M .
 . . . . . . . . . .
