 . . M . . . . . . .
 . . . . . . . . . .
 . . . . . 3 3 3 . .
 . . 0 . . . . 3 . .
 . 0 0 0 . . . . . .
 . . 0 . . . . 2 . .
 . . . . 4 4 . 2 . .
 . . . . . . . 2 . S
 . . . 1 1 . . . . .
 . . . 1 1 . . . . .
