 . . . . . . 4 . . .
 . . 0 . . . 4 . . .
 . . 0 . . . . . . .
 . . 0 . . . . . . .
 2 . 0 . . . . . . .
 2 . 0 . . . . . . .
 2 . . . 3 3 3 . . .
 2 . . . . . . . . .
 . . . M . . 1 1 1 1
 . . . . . . . . . S
