 . . . . 1 1 1 1 . .
 . 2 . . S . . . . .
 . 2 . . . . . . . .
 . 2 . . . 4 4 . . .
 . . . . . . . . . .
 . . . . . . . . . .
 . . . . . . . . . .
 . 0 0 0 0 0 0 . . .
 . . . . . . . . . .
 M . . . . . 3 3 3 .
