 . . . . 4 . . . . .
 . . . . 4 . . . . .
 . . . . . . . M . .
 . . . . 0 . . . . .
 . . . 0 0 0 . . . .
 . . . . 0 . . 1 1 1
 . . . . . . . . 1 1
 . . . . . . . . . .
 . . . . . . . S . .
 . . 3 3 3 . 2 2 2 .
