 . . 1 . S . . . . .
 . . 1 . 0 0 0 0 0 .
 . . 1 . . . . . . .
 . . 1 . . . M . . .
 . . 1 . . . . . . .
 . . . . . 2 2 2 . .
 . 3 3 3 . . . . . .
 . . . . . . . . . .
 . . . . . . . . . .
 . . . . . . . . 4 4
