 . . 4 4 . . . . 1 .
 . . . . . . . 1 . 1
 . 3 3 . . . . . 1 .
 . . 3 . . . 0 . . .
 . . . 3 . . . 0 0 0
 . . . . . . 0 . . .
 . M . . . . . . . .
 . . . . . . . 2 . .
 . . . . . . 2 . . .
 . . . . . 2 . . S .
