 . . . . . . . . . .
 4 4 . . 3 . . . . .
 . . . . 3 . . 2 . .
 . . . . 3 . . 2 . .
 . . . . . . . 2 . .
 . . 0 . . . . . . .
 . 0 0 0 S . . . . .
 . . 0 . . . . . . .
 . . . . . . 1 1 1 .
 . . M . . . . 1 1 .
