 . . 2 . . . . . 3 .
 . 2 2 . . . . 3 . .
 2 . . . . . 3 . . .
 . . . . . . . . M .
 . . . 1 . S . . . .
 . . 1 . 1 . . . . .
 . . . 1 . . . . 0 .
 . . . . . . . . 0 .
 . . 4 . . . . . 0 .
 . . 4 . . . . 0 . 0
