 . M . 0 . . . . . .
 S . . . 0 0 0 . . .
 3 . . 0 . . . . . .
 . 3 . . . . . . . .
 . . 3 . . . 1 . . .
 . . . . . 1 . 1 . .
 . . 2 . . . 1 . . .
 . . . 2 . . . . . .
 . . . . 2 . . 4 . .
 . . . . . . 4 4 . .
