 . . . . . . . . . .
 . . . . . . . 4 4 .
 3 . 0 . S . . . . .
 3 . 0 0 . . . . . .
 3 . 0 . . . . . . .
 . . 0 . . . 1 . . .
 . . 0 . . . 1 . . .
 . . . . . . 1 . . .
 . . . . . . 1 . . .
 2 2 2 . . . . . M .
