 . . . . 3 . S . . .
 . 4 4 . 3 . . 2 . .
 . . 4 . 3 . . 2 . .
 . . . . . . . 2 . 0
 . . . 1 . . . . . 0
 . . . 1 . . . . . 0
 . . . 1 . . . . . 0
 . . . 1 . M . . . 0
 . . . . . . . . . .
 . . . . . . . . . .
