 . . . . . . . . . .
 . . . . . . . . . .
 0 . 0 . . . . 3 . .
 . 0 . . 2 . . . 3 .
 . 0 . . S 2 . . . 3
 . 0 . . . . 2 . . .
 . . . 1 . . . . 4 .
 . . 1 . 1 . . . 4 4
 . . . 1 . . . . . .
 . . . . . . . . . M
