 . . . . . 0 0 0 0 0
 . . 1 . . . . S . .
 . . 1 . . . . . . .
 3 . 1 . . . . . . .
 3 . 1 . . . . . . .
 3 . . . . . . . . .
 . . . . . . . . . .
 . . . . 2 2 2 . . .
 . 4 4 . . . . . . M
 . . . 4 . . . . . .
