 . . . . . . . . . .
 . . 2 . . . . S 0 .
 . . 2 . . . . 0 0 0
 . . 2 . . . . . 0 .
 . . . . . . . . . .
 . . . . . . . . . .
 . . . . . . . . . .
 . . . 3 . . . . 4 .
 1 1 . 3 3 . . . 4 .
 1 1 . 3 . . M . . .
