 . . . . . . M . . .
 . . 0 . 0 . . . . .
 . . . 0 0 0 . 2 . .
 . . 0 . . . . . 2 .
 . . . . . . . . . 2
 . . . . . . . 1 . .
 . . . . . . 1 . 1 S
 . 4 4 . 3 . . 1 . .
 . . . . . 3 . . . .
 . . . . . . 3 . . .
