 . . . . . . 3 3 3 .
 . . . . . S . . . .
 . . 0 . . 4 . . . .
 . 0 0 0 . 4 4 . . .
 . . 0 . . . . . . .
 . . . . . . . . . .
 M . . . . . . . . .
 . . . . . . . 1 1 .
 . . . . . . . 1 1 .
 2 2 2 . . . . . . .
