 . . 3 . . . . . . M
 . . 3 . . . S . . .
 . . 3 . . . . . 0 .
 . . . . 0 0 0 0 0 .
 . . . . . . . . . .
 . . . . . . . . . 1
 . . . . . . . . . 1
 2 . . . . . . . . 1
 2 . . . . . 4 4 . 1
 2 . . . . . . . . .
