 . . . . . . . 4 4 .
 . . 3 . . 2 . . . .
 . . . 3 . . 2 . . .
 . . . . 3 . . 2 . .
 0 S 0 . . . . . . .
 . 0 . . . . . . . .
 . 0 . . . . . 1 . .
 . 0 . . . . 1 . 1 .
 . . . . . . . 1 1 .
 . . M . . . . . . .
