 . . . . 3 . . . 4 4
 . . . 3 . . 2 . 4 .
 . . 3 . . 2 . . . .
 . . . . 2 . . . . .
 . . . . . . . . 1 .
 . . . M . . . 1 . 1
 . . . . . 0 . . 1 .
 . . 0 0 0 . . S . .
 . . . . . 0 . . . .
 . . . . . . . . . .
