 . . . . . . . . . .
 . . . . . . . . . .
 3 3 3 . 0 . . . . .
 . . . . 0 . . . . .
 M . . . 0 . . . . .
 . . . . 0 . . . . .
 . . . . 0 . . . 1 .
 4 . S . . . . . 1 .
 4 . 2 2 2 . . . 1 .
 . . . . . . . 1 1 .
