 . . . . 3 3 3 . . .
 4 4 . . . . . . . .
 . . . . 0 . . . . .
 . . . . 0 . . . . .
 . . . . 0 . . . . .
 1 . . . 0 0 . . . .
 1 . 2 . 0 . . . . .
 1 . 2 . . . . . . .
 1 . 2 . S . . . . .
 . . . . . M . . . .
