 1 1 . . M . . . . .
 1 1 . . . . . 3 3 3
 . . . . . S . 3 . .
 . . . . . . . . . .
 . 0 . . 4 . . . . .
 0 0 0 . 4 . . . . .
 . 0 . . . . . . . .
 . . . . . . . . . .
 . . . . 2 2 2 . . .
 . . . . . . . . . .
