 . . . . 3 . 4 . . .
 . 3 . 3 . . 4 . . .
 . . 3 . . . . . . .
 . . . . . . . . . .
 . 0 . 0 . . . 1 . .
 . . 0 . . . 1 . 1 .
 M . 0 . . . . 1 . .
 . . 0 . . S . . . 2
 . . . . . . . . 2 .
 . . . . . . . 2 . .
