 . . . . . . 2 2 2 .
 . . . . . . . . . .
 . 3 . . 1 1 1 1 . .
 . 3 . . . . . . . .
 . 3 . . . . . . . .
 . . 3 . . . . . . .
 . S . . . . . 4 4 .
 M . . . . . . . . .
 . . . . 0 0 0 0 0 .
 . . . . . . . . . .
