 2 . . . . . . . . .
 . 2 . . . . . . . 4
 . . 2 . . 1 . . . 4
 . . S . 1 . 1 . . .
 . . . . . 1 . . . .
 . 3 3 . . . . . . .
 . 3 . . . . . . 0 .
 3 . . M . 0 0 0 . .
 . . . . . . . . 0 .
 . . . . . . . . . .
