 . . . . . 4 4 . 3 .
 . . . . . . . . 3 .
 . . 2 . . . . 3 . .
 . . . 2 . . 3 . . .
 . . . . 2 . . . . M
 . . 0 . . . 1 . . .
 . . 0 . . 1 . 1 . .
 . . 0 S . . 1 . . .
 . 0 . 0 . . . . . .
 . . . . . . . . . .
