 . . . 2 . . 0 . 0 .
 . 1 . . 2 S . 0 . .
 1 . 1 . . 2 . 0 . .
 . 1 . . . . . 0 . .
 . . . . M . . . . .
 3 . . . . . . . . .
 . 3 . . . . . . . .
 . . 3 . . . . . . .
 . . . . . . . 4 4 .
 . . . . . . . . 4 .
