 . . . . . . . . . .
 . . . . . . 1 1 1 1
 . . . . 3 . . . . .
 . 3 3 3 . . . . . .
 . . . . . . . . 4 4
 . . . . . . . . . .
 2 2 2 . . . . M . .
 . . . . . S . . . .
 . . . . 0 0 0 0 0 .
 . . . . . . . . . .
