 . . . . . S . . . .
 . . . . . . . 1 . .
 . . . 3 . . 1 . 1 .
 . . 3 . . . . 1 . 1
 . 3 . . . . . . . .
 . . . . . . . . . .
 . 0 . 0 . 4 . . . .
 . . 0 . . 4 . . 2 .
 M . 0 . . . . 2 . .
 . . 0 . . . 2 . . .
