 . . . 1 1 1 1 . . .
 . . . . . . . . . .
 3 . . . . M . . . .
 3 . . . . . . . . .
 3 . . . . . . . . .
 . . . . . 0 0 0 0 0
 4 4 . . . . . . . .
 S . . . . . . 2 . .
 . . . . . . 2 2 2 .
 . . . . . . . . . .
