 . . . . . M . . . .
 . . . . . . . 0 . .
 . . . . 0 0 0 . . 4
 . 2 . . . . . 0 . 4
 . . 2 . . . . . . .
 . . . 2 2 . . S . .
 . . . . . . . . . .
 . . 3 . . 1 . . . .
 . 3 . . 1 . 1 . . .
 3 . . . . 1 . . . .
