 . . . . 2 . . M . .
 . 1 . . . 2 . . . .
 1 . 1 . . . 2 . . S
 . 1 . . . . . . . .
 . . . . . . 0 . . .
 . 3 . . . . . 0 0 0
 . . 3 . . . 0 . . .
 . 3 . . . . . . 4 .
 3 . . . . . . . 4 .
 . . . . . . . . . .
