 . . . . . . . . . .
 . . . . . . . 0 . .
 . . . 1 1 . 0 0 0 .
 . . . 1 1 . . 0 . .
 4 . . . . . . . . .
 4 . . . . . M . . .
 . 4 . . . . . . . .
 . S . . 2 2 2 . . .
 . . . . . . . . . .
 3 3 3 . . . . . . .
