 2 . . . . . . . . .
 2 . . . . . . . . .
 2 . . . . . 3 . . .
 . S . M . . 3 . . .
 . . . . . . 3 . . .
 . . . . 0 . . 3 . .
 . . . 0 0 0 . . . .
 1 1 . . 0 . . . . .
 1 1 . . . . . 4 4 .
 . . . . . . . . . .
