 . . . . . . . . . .
 . . . . . . . . . .
 . . . . . 1 . . . .
 0 . 0 . . 1 . . 4 .
 . 0 . . 1 . 1 . 4 .
 . 0 . . . 1 . . . .
 . 0 . . . . . . . 3
 . . . . . 2 . . 3 .
 . . . . 2 . . 3 . .
 . M S 2 . . . . . .
