 . . 4 . . . . . . .
 2 . . 4 4 . . . . .
 2 . . . . . 0 . . .
 2 . . . 1 . 0 . . .
 . . . . 1 . 0 . . .
 . S . . 1 . 0 . . .
 . . . . 1 . 0 . . .
 . 3 . . . . . . . M
 . 3 . . . . . . . .
 . 3 . . . . . . . .
