 . . . . . . . . . .
 . . . . . . . . . .
 . . 1 1 . . . . 0 .
 . . 1 1 . . . 0 0 0
 M . . . . . . . 0 .
 . . . . . S . . . .
 . . . . 2 . . . . .
 . . . . 2 . 3 . . .
 . 4 4 . 2 . . 3 3 3
 . . . . . . . . . .
