 4 4 . . . . . . 1 .
 . . . . . . . 1 . 1
 . . . . . . . . 1 .
 . . . . . . 3 . . .
 . 0 . 0 . . . 3 . .
 . . 0 . . . . . 3 .
 S . 0 . . . . . . .
 . . 0 . 2 . . . . .
 . . 0 . . 2 . . . .
 M . . . . . 2 . . .
