 . 0 . . . . . . M .
 0 0 0 . . . . . . .
 . 0 . . . . . . . .
 . . . . . 2 . . 4 .
 . . . . . 2 . 4 . .
 . . . . . 2 . 4 . 3
 . . 1 1 . . . . . 3
 . . 1 1 . . . . . 3
 . . . . . . . . . .
 . . S . . . . . . .
