 . . . . 0 . 0 . . .
 . . . 0 0 0 . . . .
 . . . . 0 . . 2 2 2
 . . . . . . . . . .
 M . . . . . . . . .
 . . . . . . . . S .
 . 3 . . . 4 . . 1 1
 . 3 . . . 4 . . 1 1
 . 3 . . . . . . . .
 . . . . . . . . . .
