 . . . 1 . . M . . .
 . . 1 1 . . . . . .
 . . 1 1 . . . . . .
 2 . . . . . 0 . . .
 2 . . S . 0 0 0 . .
 2 . . . . . 0 . . .
 . . . . . . . . . .
 . . . . . . . 3 . .
 . 4 . . . . . 3 . .
 . 4 . . . . . 3 . .
