 . 3 . . . . . . . .
 . . 3 . . . 1 . . .
 . . . 3 . 1 . 1 . .
 . 2 . . . . 1 . . .
 . . 2 . . . . . . .
 . . . 2 2 . . 0 . .
 . . . . . . . 0 . .
 . . . . . . . 0 . .
 4 . . . . S 0 . 0 .
 4 . . M . . . . . .
