 . . 4 . M . . 2 . .
 . . 4 . . . . . 2 .
 . . . . . . . . 2 .
 . . . 3 3 3 . . 2 .
 . . . . . . . . . .
 . . . . . . . . . .
 . 0 . . . . S . . .
 0 0 0 . . . . . . .
 . 0 . . . . 1 1 . .
 . . . . . . 1 1 . .
