 . 1 . . . . . . . .
 . 1 . . 2 . . . . .
 . 1 . . 2 . . . . .
 . 1 . . 2 . . . . .
 . . . . . . . M . .
 . . . . 4 . . . . .
 . . . . 4 . . . . .
 . 3 . . . . . . . S
 3 3 . . . . . . . .
 . 3 . . . 0 0 0 0 0
