 4 . . . . . . . . .
 4 . . . . . . . . .
 . . . . . . . . . .
 . . . . . . . 2 2 2
 . 0 0 . . . . . . .
 0 0 0 . . . . . . .
 . 0 . . . . . . 3 .
 . . . . S . . . 3 .
 . . . . . 1 1 . 3 .
 . . . M . 1 1 . . .
