 . . . . . . . . . .
 . S . . . . 3 . . .
 . . . . . 3 . . 4 4
 . 1 . . 3 . . 4 . .
 1 . 1 . . . . . . .
 . 1 . . . . . . . .
 . . . . . . 0 . . .
 . . . . 2 . 0 . . M
 . . . 2 . . 0 . . .
 . . 2 . . 0 . 0 . .
