 . . . . . . . . . .
 . 2 . . . . . . . .
 . 2 . . . . 3 . S .
 . 2 . . 3 3 3 . 1 1
 . . . . . . . . 1 1
 . . M . . 0 . . . .
 . . . . 0 0 0 . . .
 . . . . . 0 . . . .
 . . . . . . . 4 4 .
 . . . . . . . . . .
