 3 . . . . . . 2 . .
 . 3 . . . . 2 . . .
 . . 3 . . 2 . . 4 4
 . . . . . . . . . .
 . S . . . . . M . .
 . 0 0 . . . . . . .
 . . . 0 0 0 . . . .
 . . 0 . . . . 1 . .
 . . . . . . 1 . 1 .
 . . . . . . . 1 . .
