 . . 4 4 . . 1 . . .
 . . . . . . 1 . . .
 . . . . . . 1 S . .
 . . . . . . 1 . . .
 0 . . . . . . . . .
 0 . 2 2 . . . . . .
 0 . 2 . . 3 . . . .
 0 . 2 . . 3 . . . .
 0 . . . . 3 . . . M
 . . . . . . . . . .
