 . . . . 2 S . . . .
 . . . . 2 . . . . .
 . . . . 2 . . . . .
 . . . . . . M . . .
 . . . . . . . . . .
 . 0 . . . . . . . .
 . 0 . . . 1 1 1 1 .
 . 0 . 3 . . . . . .
 . 0 . 3 . . . . . .
 . 0 . 3 . 4 4 4 . .
