 . . . . 2 2 2 . . .
 . . . . . . . . . .
 . M . . . . . . . 4
 . . . . . 1 . . . 4
 . . . 1 1 1 1 . . .
 . . . . . . . . . .
 . . . . 0 0 0 0 0 .
 . . . . . . . . . .
 . . . . . . . . . .
 . . . . 3 3 3 S . .
