 . . 2 2 2 . . M . .
 . . . . . 2 . . . .
 . . . . . . . . . .
 . . . . . . . . . .
 . . . 0 . . . . 1 1
 . . 0 0 0 S . . 1 1
 . . . 0 . . . . . .
 . . . . . 3 3 3 . .
 . . . . . . . . . .
 . . 4 4 . . . . . .
