 . . M . . . . . . .
 . . . . . . . . . .
 . . . . . 2 2 2 . .
 1 1 . . . . . . . .
 1 1 . . 3 3 3 3 . .
 . . . . . . . . . .
 . . . . 0 . . . . 4
 . . . 0 0 0 . . . 4
 . . . . 0 . . S . .
 . . . . . . . . . .
