 M . . . 2 . . . . .
 . . . . 2 . . . . .
 3 . 1 . 2 . . . . .
 3 . 1 . . . . . . .
 3 . 1 . . 4 4 . . .
 . . 1 . . . . . . .
 . . . . . . . . . .
 . . . 0 0 0 0 0 . .
 . . . . . . . 0 . .
 . . . . . . . . S .
