 . . . . . . . . . .
 . . 1 . . . 0 . . .
 . . 1 . . . 0 . . .
 . 1 . 1 . . 0 . . .
 . . 1 . . 0 . 0 . .
 . . . . . . . . . .
 . . . . . . 2 . . .
 . . . . 3 . . 2 . .
 . 4 S . . 3 . . 2 .
 . 4 . M . . 3 . . .
