 3 3 3 . . . . . . .
 . . . . . . . . . .
 . 4 4 . . . . . S .
 . . . 4 . . . . . .
 . . . . . . . . 1 .
 . . . 2 . . . . 1 .
 . . . 2 . . . . 1 .
 . . . 2 . . M . 1 .
 . . . . . . . . . .
 . . 0 0 0 0 0 . . .
