 . . . . . S . . . .
 . . . . . 2 2 2 . .
 . . . . . . . . . .
 M . . 0 . . . . . .
 . . 0 0 0 . . 3 3 3
 . . . 0 . . . . . .
 . . . . . . . . . .
 . . . . . . 1 1 . .
 . . . . . . 1 1 . .
 . 4 4 . . . 1 . . .
