 . 2 . . . . . . . .
 . 2 . . . . . . . .
 . 2 . 4 . M . . 1 .
 . . . 4 . . . . 1 .
 . . . . . . . . 1 .
 S . . . . . . . 1 .
 . . . . . . . . . 1
 . . 0 0 0 0 0 . . .
 . . . . . . . . . .
 . . . . . 3 3 3 . .
