 . . . 3 . . . . . .
 . . . 3 . M . . . .
 . . . 3 . . . . . .
 . . . . . . 2 2 2 .
 1 . . . . . . . . S
 1 1 1 1 . . . . . .
 . . . . . . . . . .
 . . . . . . . . . .
 4 4 . 0 0 0 0 0 . .
 . . . . . . . . . .
