 . . . . . . . . 3 .
 2 . . . . S . 3 . .
 . 2 . . . . 3 . . 4
 . . 2 . 0 . . . . 4
 . . . . . 0 . 0 . .
 . . . . . . 0 . . .
 . . . . . . 0 . . .
 . . 1 . . . 0 . . .
 . 1 . 1 . . . . . .
 . . 1 . . . . . M .
