 . . . S . . . . . .
 . . . . . 3 3 3 . .
 . . 0 . . . . . . .
 . . 0 . . . . . . .
 . . 0 . . . 2 2 2 .
 . . 0 . M . . . . .
 . . 0 . . . . . . .
 . . . . . . . . . .
 . . . . . . . . 4 .
 1 1 1 1 . . . 4 4 .
