 . 1 . . . . . . . .
 . . 1 1 . . . . . .
 . . 1 1 . . . . . .
 2 . . . . . . . . .
 2 . . . . . . . 0 .
 2 . . . . . S 0 0 0
 . . . . . . . . 0 .
 . 3 3 3 . . . . . .
 . . . . . . . M . .
 4 4 . . . . . . . .
