 . . S . 2 2 2 . . 0
 . . . . . . . . . 0
 . . . . 1 . . . . 0
 . . . . 1 . . . . 0
 . . . . 1 . . . . 0
 . . . . 1 . . . . .
 . 4 4 . . . . . . .
 . . . . . . . . . .
 . . . . 3 . M . . .
 . . 3 3 3 . . . . .
