 . . . . . . . . . .
 . . . . . . . . . .
 . . . . . 3 . . . 0
 . . . 3 3 3 . . . 0
 . . . . . . . . S 0
 . . . . . . . . . 0
 2 2 2 . . . . . . 0
 . . . . . . . . . .
 . . . . . . . . . .
 4 4 . 1 1 1 1 . M .
