 . 1 . . . . . . . .
 . 1 . . . . . . . .
 . 1 . . . . 0 . . .
 . 1 . 2 . 0 0 0 0 0
 . . . 2 . . . . . .
 3 . . 2 . . . . . .
 3 . . . . . . . . .
 3 . . S . . . M . .
 . . . 4 4 . . . . .
 . . . . . . . . . .
