 . . . . . 4 S . 3 .
 . . . . . 4 . . 3 .
 . . . 0 . . . . 3 .
 . . 0 0 0 . . . . .
 . . . 0 . . . . . .
 . . . . . . . . . 2
 . . . . . . 2 2 2 .
 . 1 1 . . . . . . .
 . 1 1 . . . . . M .
 . . . . . . . . . .
