 . . . . . . . 3 . .
 0 . . . . . . . 3 .
 . 0 0 0 . . . . . 3
 0 . . . . . . . . .
 . . . . . 4 . . . .
 . . . . . 4 . . . .
 . . 2 . . 4 . . 1 .
 . S . 2 . . . 1 . 1
 . . . . 2 . . . 1 .
 . M . . . . . . . .
