 . . . . . 3 . . M .
 . . . . . . 3 . . .
 . . 1 . 1 . . 3 . .
 . 1 . 1 . . . . . .
 . . 1 . . . . 2 . .
 . . . . . 0 . . 2 .
 4 4 . . . 0 . . . 2
 . . . . . 0 . . . .
 . . . S 0 . 0 . . .
 . . . . . . . . . .
