 . . . . . 2 . . . .
 . . . . 2 . S . . .
 . . . 2 . . 3 . . .
 . . . . . 3 . . 1 .
 . . . . 3 . . 1 1 1
 . . . . . . . . 1 .
 4 4 . 0 . . . . . .
 . . . . 0 0 0 . . .
 . . . 0 . . . . . .
 . M . . . . . . . .
