 . . . . . . . . . .
 . . . . . 3 . . . .
 . . . . . 3 . . . .
 . . 0 . . 3 . . . .
 . . 0 . . . . . . .
 . . 0 . . . 2 2 2 .
 . . 0 . . 2 . . . .
 . . 0 . . . . . . .
 S . . . . . . . . M
 . 1 1 1 1 . 4 4 . .
