 . . . . . . . . . .
 . . . . . . . . . .
 4 4 . . . . . 2 . .
 . . . . 1 . . 2 . .
 . . . . 1 . . 2 . S
 . . . . 1 . . . . 0
 M . 3 . 1 . . . . 0
 . . 3 . . . . . . 0
 . . 3 . . . . . . 0
 . 3 . . . . . . . 0
