 . . . . . . . . 0 .
 . . . . . . . 0 0 0
 . . . . . . . . 0 .
 . . 2 . . . . . . .
 M . 2 . . . . . . .
 . . 2 . . . 3 3 3 .
 . . . . . S . . . .
 . . . . 1 1 . . . 4
 . . . . 1 1 . 4 4 .
 . . . . . . . . . .
