 . . S . . . . . . .
 . 0 . . . . . . 4 4
 0 0 0 . . . . . . 4
 . 0 . . . . 1 1 . .
 . . . . . . 1 1 . .
 . . . . . . . . . .
 . 3 . . . . . 2 2 2
 . 3 . M . . . . . .
 . 3 . . . . . . . .
 . . . . . . . . . .
