 . . . . . . . . . .
 . . . . . . . . . .
 . . . . . . . . . .
 . . . . . . . 2 2 2
 . . . 1 . . . . . .
 . M . 1 . . . . . 4
 . . . 1 . . . . . 4
 3 . . 1 . . 0 . . .
 3 . S . . 0 0 0 0 0
 3 . . . . . . . . .
