 . 3 3 3 . . 2 2 2 .
 S . . . . . . . . .
 . . . . . . 0 . . .
 . . . M . . 0 . . .
 . . . . . . 0 . . .
 . . . . 1 . 0 . . .
 . . . . 1 . 0 . . .
 . . . . 1 . . . . .
 . 4 4 . 1 . . . . .
 4 . . . . . . . . .
