 . . . . . . . . . .
 . . . . . . . . . .
 . . . 1 1 . . . . .
 . . . 1 1 . . . . .
 . . . . . . . . . .
 . . . . . 0 . . . M
 2 2 2 . 0 0 0 . . .
 . . . S . 0 . 0 . .
 . . . . . . . . . .
 . 3 3 3 . 4 4 . . .
