 . . . 4 4 . . M . .
 . . . . S . . . . .
 . . 3 3 3 3 . . 1 1
 . . . . . . . . 1 1
 . . . . . . . . . .
 . 0 . . . . . . . .
 0 0 0 . . . . . . .
 . 0 . . . . . . . .
 . . . . . . . . . .
 . . . . 2 2 2 . . .
