 . . . M . 1 . . . .
 . . . . . 1 . . . .
 . . . . 1 1 . 4 4 S
 . . 0 . . 1 . . . .
 . . 0 . . . . . . .
 . . 0 . . . . . . .
 . . 0 . . . . 2 . .
 . . 0 . . . . 2 . .
 . . . . . . . 2 . .
 . 3 3 3 . . . . . .
