 . . . . . . . . . .
 . . . . . S 1 . 4 .
 . . . . . . 1 . 4 .
 . . . 2 . . 1 . . .
 . 2 2 2 . . 1 . M .
 . . . . . . . . . .
 . . . . . . . . . .
 3 . . . . . . . . .
 3 . . 0 0 0 0 0 . .
 3 . . . . . . . . .
