 . . . . . . . . . .
 . . 4 4 . . 3 . . .
 . . . 4 . . 3 . . .
 . . . . . . 3 . . .
 . . . 0 . . . . . .
 S . 0 0 0 . . . . .
 . . . 0 . . 1 1 . .
 . . . . . . 1 1 . .
 . . . . M . . . . .
 . . . . . . . 2 2 2
