 . . . . . . . . . .
 . . . . . . 0 . 0 .
 3 3 3 . . 0 0 0 . .
 . . . . . . 0 . . .
 . . . . . . . . . .
 . . . . 2 . . . . .
 . . . . 2 . . 1 1 S
 . . . . 2 . . 1 1 .
 4 . . . . . . . . .
 4 . . . . . . . . M
