 . . . 1 1 1 1 . . .
 . 3 . . . . . . . .
 3 3 . . . 0 . . 4 .
 . 3 . . . 0 . . 4 .
 . . . . . 0 . . . .
 . 2 2 2 . 0 . . . .
 . . . . . 0 . . . .
 . . M . . . . . . .
 . . . . . S . . . .
 . . . . . . . . . .
