 . . . . . . . . . 2
 . . . 4 4 . . . . 2
 . M . . . . . . . 2
 . . . . . . . . . .
 . . . . . . . . . .
 1 1 . . . . . . 0 S
 1 1 . . 3 3 . 0 0 0
 . . . . . 3 . . 0 .
 . . . . . 3 . . . .
 . . . . . . . . . .
