 . 1 . . . . . . . .
 1 . . . . . . . 4 4
 1 . . 2 . . . . . .
 1 . . 2 . . . . . .
 1 . . 2 . . . . . .
 . . . . . . . . 0 .
 . . 3 3 3 . . . 0 .
 . . . . . . . . 0 .
 . . . . . . . . 0 .
 . . . M . S . . 0 .
