 . 2 2 2 . . . . . .
 . . . . . . . . 0 .
 . . . . . . . 0 0 0
 . . . . . . . . 0 S
 . . . . . . . . . .
 . . . . . . . . 4 .
 3 3 3 . . . . 4 4 .
 . . . . . . . . . .
 . . . 1 1 . M . . .
 . . . 1 1 . . . . .
