 . . . . . . . 3 . .
 . . 1 . . . . . 3 .
 . 1 . 1 . 0 . . . 3
 . . 1 . . . 0 . . .
 . . . . . . 0 . . 4
 S . . . . . 0 . . 4
 . . . . . 0 . 0 . .
 . . . 2 . . . . . .
 . . 2 . . . . . . .
 . 2 . . . . . . . M
