 . . . . 2 2 2 2 . .
 . . 0 . . . . . . .
 . . 0 . . . 3 3 3 .
 . . 0 . . . . . . .
 . . 0 . M . . . 1 .
 . . 0 . . . . . 1 .
 . . . . . . . . 1 .
 . . . . . 4 4 . 1 .
 . . . . . . . S . .
 . . . . . . . . . .
