 . 3 3 3 . . . . 2 .
 . . . . . . . 2 2 .
 . M . . . . . . 2 .
 . . . 0 . . . . . S
 . . 0 0 0 . . . . .
 . . . 0 . . . 4 . .
 . . . . . . . 4 . .
 . . . . . . . . . .
 . . . . 1 1 . . . .
 . . . . 1 1 . . . .
