 4 . 2 . . . . . . .
 4 . . 2 . . . . 1 .
 . . . . 2 . . 1 . 1
 . M . . . . . . 1 .
 . . . . . . . . . .
 . . 3 . . . . . . .
 . 3 . . . . . . . .
 3 . . . . . 0 . . .
 . . . . . . . 0 0 0
 . . . . S . 0 . . 0
