 . . . . 1 1 . . . .
 . . . . 1 1 . . . .
 . . . . . . . . . 2
 . . . . . . 2 2 2 .
 . 4 . . . . . S . .
 . 4 . . . . . . . .
 . . . . . . . . . .
 . . . 3 3 3 . . 0 .
 . . . . . . . 0 0 0
 . . . M . . . . 0 .
