 . . . . . . 2 2 2 .
 . . . . . . . . . .
 4 . . 0 . . . . S .
 4 . 0 0 0 . . . . .
 . . . 0 . . . 1 1 .
 . . . . . . . 1 1 .
 . . . . . . . . . 1
 . . . 3 3 3 . . . .
 . . . . . . . . . .
 M . . . . . . . . .
