 . . . 2 . . . . . .
 . . . 2 . 3 3 3 . .
 . S . 2 . . . . . .
 . . . . . . . . 1 1
 . . . . . . . . 1 1
 4 . . 0 . . . . . .
 4 . 0 0 0 . . . . M
 4 . . 0 . . . . . .
 . . . . . . . . . .
 . . . . . . . . . .
