 4 . . . . . . . M .
 4 . . . . 0 . . . .
 . . . . . . 0 0 0 .
 . . 1 . . 0 . . . .
 . 1 . 1 . . . 3 . .
 . . 1 . . 2 . . 3 .
 . . . . 2 . . . . 3
 . . . 2 . . . . . 3
 . . . . . . . . . .
 . S . . . . . . . .
