 . . . . . . . . . .
 . . S . . . . . . .
 . . . 3 3 3 . . . .
 . . . . . . . . M .
 1 . 0 . . 2 . . . .
 1 . 0 . . 2 . . . .
 1 . 0 . . 2 . 4 . .
 1 . 0 . . . . 4 4 .
 . . 0 . . . . . . .
 . . . . . . . . . .
