 . . . . . . . . 4 4
 . . . 1 1 . . . . .
 . . . 1 1 . . . 0 .
 . . . S . . . 0 0 0
 . . . . . . . . 0 .
 . . . . . 3 . . . .
 2 . . . 3 3 3 . . .
 2 . . . . . . . . .
 2 . . . . . . . . M
 . . . . . . . . . .
