 . . . . . . . . . M
 . . 2 . . . . . . .
 0 . 2 . . . . . . .
 0 . 2 . . . . . . 4
 0 . . . . 3 3 3 . 4
 0 . . . . . . . . .
 0 . . . . . . . . .
 0 . . . S . . . . .
 . . . 1 1 1 1 . . .
 . . . . . . . . . .
