 . . . . . . . 4 . .
 . . . . 2 . . . 4 4
 . . . . 2 . . . . .
 . . 3 . 2 . . . . .
 . . 3 . . . S . . .
 . . 3 . . . . . . M
 . . . . . . 0 . . .
 1 1 . . . 0 0 0 . .
 1 1 . . . . 0 . . .
 . . . . . . . . . .
