 . . 3 . . . . . . .
 . . 3 . . . 0 . . .
 . . 3 . . . 0 . . .
 . S . . . . 0 . . .
 . . . . . . 0 . . .
 . . 1 . . . 0 . 2 2
 . . 1 . . . . . 2 .
 . . 1 . . . . . 2 .
 . . 1 . . . . . . .
 . . . . . 4 4 . M .
