 . . . . . . . . 3 .
 . . 2 . . . . 3 . 3
 . . . 2 . . 3 . . .
 . . . . 2 . . . . .
 M . . . . . 4 4 . .
 S . 1 . . . . . . 0
 . 1 . 1 . . 0 0 0 .
 . . 1 . . . . . . 0
 . . . . . . . . . .
 . . . . . . . . . .
