 . . . 0 . 0 . 2 . .
 . . . . 0 . . . 2 .
 . . . . 0 . . . . 2
 . . . . 0 . . . . .
 . . . . . . . 4 4 .
 . . . 1 . . . . 4 .
 . . 1 . 1 . S . . .
 . . . 1 . . . 3 . .
 . . . . . . 3 . . .
 . . . . . 3 . . . M
