 . . . . . . . . 2 .
 . . . . . . . . 2 .
 1 . . . 3 3 3 . 2 .
 1 . . . . . . . . 2
 1 . S 0 0 0 0 0 . .
 1 . . . . . . . . .
 . . . . . . 4 4 . M
 . . . . . . . . . .
 . . . . . . . . . .
 . . . . . . . . . .
