 . . . . . . . 4 4 .
 . . . 1 1 . . . . .
 . . . 1 . 1 . . . .
 . . . . 1 . . 2 . .
 . . . . . . . . 2 .
 . . . 0 . . . . . 2
 0 0 0 . . . M . . .
 . . . 0 . . . . 3 .
 . . . S . . . 3 . .
 . . . . . . 3 . . .
