 . . . . . . . . . .
 . 2 . . . . . . . .
 . . 2 . 2 . . . . .
 . . . 2 . . 1 . . .
 . . . S . 1 . 1 . .
 . . . 4 . . 1 . . .
 . . . 4 . . . . 3 .
 0 . . . . . . 3 . .
 . 0 0 0 . . 3 . . .
 0 . . . . . . . M .
