 . . . . . . . . . .
 . . . . . . . . . .
 3 3 3 . . . . . . .
 . . . 3 . . S . . .
 . . . . . . . . . .
 1 . . . . 0 . . . 4
 1 . . . . 0 . . . 4
 1 . . 2 . 0 . M . .
 1 . . 2 . 0 . . . .
 . . . 2 . 0 . . . .
