 . . . . . . . . M .
 . . . . . . . . . .
 . S . 0 . . . 2 . .
 . . . 0 . . 2 . . .
 . . . 0 . 2 . . 1 .
 . . . 0 . . . 1 . 1
 . . 0 . 0 . . . 1 .
 . . . . . . 3 . . .
 . . . . . 3 . . . 4
 . . . . 3 . . . . 4
