 . . . . . . . . . M
 . . 4 4 4 . . . . .
 . . . . S . . . . .
 1 1 . . . . 3 3 3 .
 1 1 . . . . . . . .
 . . . . . 0 . . . .
 . . 2 . 0 0 0 . . .
 . . 2 . . 0 . . . .
 . . 2 . . . . . . .
 . . . . . . . . . .
