 . . . . . . . . . .
 3 . . . . . . . 4 4
 3 . . . . . . . . .
 3 . . . 1 1 . . 0 .
 . . . S 1 1 . 0 0 0
 . . . . . . . . 0 .
 M . . 2 2 2 . 0 . .
 . . . . . . . . . .
 . . . . . . . . . .
 . . . . . . . . . .
