 . . . . . 3 . . . .
 . . . . . 3 . . . .
 . . . . . 3 . . 0 .
 1 . . 2 . . . . 0 .
 1 1 . 2 . . . . 0 .
 1 . . 2 . . . . 0 .
 1 . . . . . . . 0 .
 . . . . . 4 4 . . .
 . . . S . . . . . .
 . . . . . . . M . .
