 . . . . . . . . . .
 . . 0 . . . . . . .
 . . 0 0 0 0 0 . . .
 . . . . . . . . . 3
 . . M . S . . . . 3
 . . . . . . . . . 3
 . 2 2 2 . . . . . .
 . . . . . . . . . .
 . . 4 . . . 1 1 1 1
 . . 4 . . . . . . .
