 . . . 4 4 . . . 2 .
 . . . . . . . . 2 .
 3 3 3 . . . . . 2 .
 . . . . . . . . 2 .
 . . . . . . . . . .
 1 1 . . . . M . . .
 1 1 . . . . . . . .
 . . . . . . . . 0 .
 . . . . . . . 0 0 0
 . . . . . . S . 0 .
