 . M . . . . . . . .
 . . . . . 2 . 1 1 .
 . . . . . 2 . 1 1 .
 . . . . . 2 . . . .
 . . . . . . . . . .
 . 3 3 3 . . 0 . . .
 3 . . . . 0 0 0 . .
 . . . . . . 0 . . .
 . . . . 4 . S . . .
 . . . . 4 . . . . .
