 . . . 1 1 1 1 . . .
 . . . . . . . . . .
 . 0 0 0 0 0 . . . .
 . . . . . . . . . .
 M . 3 3 3 . . . . S
 . . . . . . . . . .
 . . . . . 2 2 2 . .
 . . . . . 2 . . . .
 . . . . . . . . . .
 . 4 4 . . . . . . .
