 . . . . . 0 . . . .
 4 4 . . 0 0 0 . . .
 . . . . . 0 . . . .
 . . . . 0 . . . . .
 . . . . . . . . . .
 S . . . . . . . . .
 . . . . . . 1 1 . .
 . 2 2 2 . . 1 1 . .
 . . . . . . . . . .
 . . . . 3 3 3 . M .
