 . . . . . . . . . .
 . . M . . . . . . .
 . . . . . . 1 1 1 1
 . . . . . . . . . 1
 4 4 . . 0 . . . . S
 . . . . 0 . . . . .
 . . . . 0 . 3 3 3 .
 . . . . 0 . . . . .
 2 2 2 . 0 . . . . .
 . . . . . . . . . .
