 . . S . . . . . . .
 . 0 . . . . . . . .
 . 0 . . M . . . . .
 . 0 . . . . . . . .
 . 0 . . . . . 2 2 2
 . 0 . . . . . . . .
 . . . . 4 . . 3 . .
 . . . . 4 . . . 3 .
 . . . . . . . . 3 .
 1 1 1 1 . . . . 3 .
