 4 4 . . S . . . . .
 . . . . 0 . . . . .
 1 1 . 0 0 0 . . . 3
 1 1 . . 0 . . . . 3
 . 1 . . . . . . . 3
 . . . . . . . . . .
 . . . . . . . . . .
 . . 2 . . . . . . .
 . . 2 . M . . . . .
 . . 2 . . . . . . .
