 . . . . 1 . . . . .
 . . . 1 . 1 . . 3 .
 . . . . 1 . . 3 . .
 . . . . . . 3 . . .
 S 4 4 . . 3 . . . .
 . . . . . . . . 0 .
 . . . . . 0 0 0 . .
 M . . 2 . . . . 0 .
 . . 2 . . . . . . .
 . 2 . . . . . . . .
