 . . . . . . . . . .
 3 . . . . . . . 0 .
 3 . . . 1 1 . 0 0 0
 3 3 . . 1 1 . . 0 .
 . . . . . . . . . .
 . . . . . 4 4 . . .
 . . . . . . . . . .
 2 . . M . . . S . .
 2 . . . . . . . . .
 2 . . . . . . . . .
