 . . . . 0 . . S . 2
 4 4 . 0 0 0 . . . 2
 . . . . 0 . . . . 2
 . . . 0 . . . . . .
 . . . . . . . . . .
 . . 1 1 . . . . . M
 . . 1 1 . . . . . .
 . . . . . . . . . .
 . . . . . . . . . .
 . . . . . 3 3 3 . .
