 . . . . . . . . 3 .
 . 2 . . . . . . 3 .
 . 2 . 4 . . . . 3 .
 . 2 . 4 . . . . . .
 . . . . . . . . M .
 . 0 . 0 . . . . . .
 0 0 0 . . . . . . .
 . 0 . . . S . 1 1 .
 . . . . . . . 1 1 .
 . . . . . . . . . .
