 . . . . . . . . . .
 . . . . M . 4 . . .
 . . . . . . 4 . . .
 . 1 1 1 1 . . . . .
 . . . . . . . . . 2
 S . . . . . . . . 2
 . . . . . . . . . 2
 3 . . 0 0 0 0 0 . .
 3 . . . . . . . 0 .
 3 . . . . . . . . .
