 2 . . . . . . . . .
 2 . . . . . . . 0 .
 2 . 3 . . . . 0 0 0
 . S 3 3 3 . . . 0 .
 . . . . . . . . . .
 4 . . . . . . . . .
 4 . . . . . . . . .
 . . 1 1 . . . M . .
 . . 1 1 . . . . . .
 . . . . . . . . . .
