 . . . . 1 1 1 1 . .
 . . . . . . . . . .
 . . . . . S . 3 3 3
 . . . . . . . . . .
 . . . . . . . 0 . .
 . . . . . . . 0 . .
 . . . M . . . 0 . .
 . . . . . . . 0 . 2
 . 4 . . . . . 0 . 2
 . 4 4 . . . . . . 2
