 . . . . . . . . . .
 . . . 0 . . . . . .
 0 0 0 . . . 1 . . .
 . . . 0 . 1 . 1 . .
 M . . . . . 1 . . .
 . . 4 . . . . . . .
 4 4 . . 2 . . . . .
 . . . 2 . . S 3 . .
 . . 2 . . . . . 3 .
 . . . . . . . . . 3
