 . . 2 . . . . . . .
 . . 2 . . . 0 . . .
 S . 2 . . 0 0 0 . .
 . . . . . . 0 . . .
 . . . . . . . . . .
 . . . . . . . . . .
 . . . . . M . . . 3
 . . . . . . . . . 3
 . . 1 1 . . 4 . . 3
 . . 1 1 . 4 4 . . .
