 4 . . . . . . . . .
 4 . . . . . . . . .
 . . . . . . 0 . . .
 . . . . . 0 0 0 . .
 . . . . . . 0 . S .
 3 . . 2 . . . . . .
 3 . . 2 . . 1 1 . .
 3 . . 2 . . 1 1 1 .
 . . . . . . . . . .
 . . . . . . M . . .
