 . . . . . . . . 1 1
 . . . . . . . . 1 1
 . . . . M . 4 . . .
 . . S . . . 4 . . .
 . . 2 2 2 . . . . .
 . . . . . . . . . .
 . . . 3 . . . . . .
 3 3 3 . . . . 0 . .
 . . . . . . 0 0 0 .
 . . . . . . . 0 . .
