 . . . . . . . . . .
 . . . 2 2 2 . . . .
 . 1 . . . . . . . .
 . . 1 1 . . . . 0 .
 . . 1 1 . . . 0 0 0
 . . . . . . . . 0 S
 . 4 4 . . . . . . .
 . . . . . . . 3 . .
 . . . . . . . 3 . .
 . . M . . . . 3 . .
