 . . . . . . . . . .
 . . . . . 3 3 3 . .
 . 4 4 . . . . . . .
 4 . . . . . . . S .
 . . . . . . . . . .
 2 2 2 . . . . . . .
 . . . . . . . . 1 1
 . . . . 0 . . . 1 1
 . M . 0 0 0 . . . .
 . . . . 0 . . . . .
