 . . . . . . . . . .
 . . . . 3 3 3 . . .
 . 1 1 . . . . . . .
 . 1 1 . . M . . . .
 . . . . . . . . . .
 . . . 0 . . . . S .
 4 . 0 0 0 . . . . .
 4 . . 0 . . . . 2 .
 . . . . . . . . 2 2
 . . . . . . . . 2 .
