 . . . . . . . 4 . .
 . . . 2 2 2 . 4 . .
 . . . . . . . . . .
 . . . . . . . 3 3 3
 M . . . . . . . . .
 . . S . . . . . . .
 . . . . . . . . . .
 . 1 . . . . 0 . . .
 . 1 1 . . 0 0 0 . .
 . 1 1 . . . 0 . . .
