 . . . . 0 . . S . .
 . 0 0 0 . . . . 2 .
 . . . . 0 . . 2 . .
 . . . . . . 2 . . .
 . . 3 . . . . . . .
 M . . 3 . . . . . .
 . . . . 3 . . . . .
 . . 1 . . . . . 4 .
 . 1 . 1 1 . . . 4 .
 . . 1 . . . . . . .
