 . . . . . . . . . S
 . . . . . . . . . M
 3 . . . . . . 0 . .
 . 3 . . 0 0 0 . . .
 . . 3 . . . . 0 . .
 . . . . . . . . . .
 . . . . . . . . . .
 . 1 . 1 . . 2 . . .
 1 . 1 . . . . 2 . .
 . 1 . . 4 4 . . 2 .
