 . . . . . . . . . .
 . . 1 1 1 1 1 . . .
 S . . . . . . . 3 .
 . 2 . . . . . . 3 .
 . 2 . . . . . . 3 .
 . 2 . . . . . . . .
 . . . . . . . . . .
 . . . . . 0 0 0 0 0
 . . 4 4 . . . . . .
 . . . . . . . . . M
