 . 2 . . . 4 . . . .
 . . 2 . . 4 . M . .
 . . . 2 . . . . . .
 . . . . . . 0 . . .
 . . 0 0 0 0 . . . .
 . . . . . . 0 . . .
 . . . . . . . . . 3
 . . . 1 . . . . 3 .
 S . 1 . 1 . . 3 . .
 . . . 1 . . . . . .
