 . . . . . . . 4 4 .
 . . 1 . . . . . . .
 . . . 1 1 1 1 . . M
 . . . . . . . . . .
 . . . S 2 . . . . .
 . . . . 2 . . . 0 .
 . . . . 2 . . . 0 .
 . . 3 . . . . . 0 .
 . . 3 . . . . . 0 .
 . . 3 . . . . . 0 .
