 . M . . . 3 . . . .
 . . . . 3 . . . . .
 . . . 3 . . . 2 . .
 . . . . . . 2 S 2 .
 . . 1 . . 2 . . . .
 . 1 . 1 . . . 4 4 .
 . . 1 . . . . . . .
 . . . . 0 . . . . .
 . . . . . 0 0 0 . .
 . . . . 0 . . . . .
