 . 2 2 2 . . . . . .
 . . . . . . . . . .
 . . . . . . S . . .
 . . 0 . . . . . . .
 . 0 0 0 . 3 3 3 . .
 . . 0 . . . . . . .
 . . . . . . . . M .
 . . . . 1 1 . . . .
 . . . . 1 1 . . 4 .
 . . . . . . . 4 4 .
