 . . . 3 . . M . . .
 . . . 3 . . . . . .
 . . . 3 . . . . 0 .
 . . . . . 4 4 . 0 .
 2 . 1 . . . . . 0 .
 2 . 1 S . . . . 0 .
 2 . 1 . . . . . 0 .
 . . 1 . . . . . 0 .
 . . . . . . . . . .
 . . . . . . . . . .
