 . . . . 2 . . . . .
 . . . 2 . . . 3 . .
 . . 2 . . 0 . . 3 .
 . . . . . 0 . . . 3
 M . . . . 0 . . . .
 . . . . 0 . 0 . 4 .
 . . . . . . . . 4 4
 . . . . . 1 . . . .
 . . . . 1 . 1 . . .
 . . . . . 1 . S . .
