 . . . . . . . . . .
 . . . . . . . . . 4
 . . . . . . 0 . . 4
 . . . 0 0 0 . . . .
 . . . . . . 0 . . 2
 . M . . . . . . 2 .
 . . . . . . . 2 . .
 . 1 1 . . . . . S 3
 1 . 1 . . . . . 3 .
 . 1 . . . . . 3 . .
