 . 3 3 3 . . . . . .
 . . . . . . 1 . . .
 M . . . . . 1 . . .
 . . 4 4 . . 1 . . .
 . . . . S . 1 . . .
 . . . 0 . . 1 . . .
 . . . 0 . . . . 2 .
 . . . 0 . . . . 2 .
 . . . 0 . . . . 2 .
 . . . 0 . . . . . .
