 . . . . . . . M . .
 4 . . . S . . . . .
 4 . 0 . . 3 . . . .
 . . 0 . . . 3 . . .
 . . 0 . . . . 3 . .
 . 0 . 0 . . . . . .
 . . . . . 2 . . . .
 . . . . 2 . . 1 . .
 . . . 2 . . 1 . 1 .
 . . . . . . 1 1 . .
