 . . . . 4 4 . . . .
 . . . . . . . . 2 .
 . . . . . . . 2 . .
 . . . . . . 2 . . .
 . . 0 . 0 . . . . .
 . . . 0 . . . . . M
 . 3 . 0 . . . 1 . .
 3 . . 0 . . 1 . 1 .
 . 3 . . . . . 1 . S
 . . 3 . . . . . . .
