 . . . . . . . . . .
 M . . . . . . . . .
 . . . . . . S . . .
 . . . . . . . . 4 4
 . . . . . . . . . .
 . 0 0 0 0 0 . . . 1
 . . . . . . . . . 1
 . 2 . . . . 3 . . 1
 . . 2 2 2 . 3 . . 1
 . . . . . . 3 . . .
