 . S 1 1 . . . . M .
 . . 1 1 . . . . . .
 . . . . 1 . . . . .
 . . . . . . . . . .
 . . . . . . 0 . . .
 . . . . . 0 0 0 . 3
 . . . . . . 0 . . 3
 . . . . 2 . . . . 3
 4 4 . . 2 . . . . .
 . . . . 2 . . . . .
