 . 4 4 . . . . . . .
 . . . . . . . . . .
 . . 2 2 2 . M . . 0
 . . . . . . . . . 0
 . . . . . 1 1 . . 0
 . . . . . 1 . . . 0
 S . . . . 1 . . . 0
 3 . . . . 1 . . . .
 3 . . . . . . . . .
 3 . . . . . . . . .
