 . . . . . . . . . .
 . . . . . . . . . .
 . . . 3 3 3 . . . .
 . M . . . . . . . .
 . . . . . 0 . . 4 .
 . . . . 0 0 0 . 4 .
 . . . 0 . 0 . . . .
 . . . . . . . . . .
 . . . 1 1 . 2 2 2 .
 . . . 1 1 . . . S .
