 . . . . . . . 3 3 3
 . 1 1 . . . . . . .
 . 1 1 . . . . . . .
 . . . . . 4 4 . . .
 . . 2 . 4 . . . . .
 . . 2 . . . . . . .
 . . 2 . . . S . 0 .
 . . . . . . . 0 0 0
 . . M . . . . . 0 .
 . . . . . . . . . .
