 . . . . . . . . . .
 . . . . . 0 0 0 0 0
 . . . . . . 0 . . .
 . 1 1 1 1 . . . . .
 . . . . . . 4 4 . .
 . . . . . . . . . .
 M . . . . . . . 2 .
 S . . 3 3 3 . . 2 .
 . . . . . . . . 2 .
 . . . . . . . . . .
