 . . . . . 3 . . . .
 . . . . . 3 . . . .
 . . . . . 3 . . 0 .
 . . . . . . . 0 0 0
 . . 2 . . . . . 0 .
 2 2 2 . 4 4 . . . .
 . . . . . . . . . .
 . . . . . . . . . .
 . . . . . 1 1 . . .
 M . . . . 1 1 . S .
