 . . . . . . . . . .
 . . . 2 2 2 . . . .
 4 . . . . . . . . S
 4 . 0 0 0 0 0 . . .
 . . . . . . 0 . . 1
 . . . . . . . . . 1
 . . . . 3 . . . . 1
 . . M . 3 . . . . 1
 . . . . 3 . . . . .
 . . . . . . . . . .
