 . . . . . 0 . . . .
 . . . . 0 0 . . . .
 . . . . . 0 . 2 2 2
 . . . . . 0 . . . .
 3 . M . . 0 . . . .
 3 . . . . . . . . .
 3 . . . . 4 4 . . .
 . . . . . . . S . .
 . . . . . . . . . .
 . . . 1 1 1 1 . . .
