 . . . . . . . . . .
 . . . . . . . . . .
 2 2 2 2 . . 3 3 3 .
 . . . . . . . . . .
 . . 1 . . 0 . . . .
 . . 1 . . 0 . . 4 .
 . . 1 . . 0 . . 4 .
 . . 1 . . 0 . . . .
 S . . . . 0 . . . M
 . . . . . . . . . .
