 . 4 4 . . . M . . .
 4 . . . . . . . . .
 . . 1 1 1 1 . . . .
 . . . . . . . . . .
 . . . . . . . . . .
 . . . . . 0 . . . .
 2 . . . . 0 . . . .
 2 S 3 . . 0 . . . .
 2 . 3 . . 0 . . . .
 . . 3 . . 0 . . . .
