 . 1 1 . . . . . . .
 . 1 1 . . . . . . .
 . . . . . . . . . .
 . . . . . . . 3 . .
 . . . . . . . 3 . .
 4 . . 0 . . . 3 . .
 4 . 0 0 0 . S . . .
 . . . 0 . . 2 . . M
 . . . . 0 . 2 . . .
 . . . . . . 2 . . .
