 . . . . . . . . . .
 . . . . . . . . . .
 . 1 . . . . . . . .
 . 1 . . . 0 . 2 2 2
 . 1 . . . 0 . . . .
 . 1 . 3 . 0 . M . .
 . . . 3 . 0 . . . 4
 . . . 3 . 0 . 4 4 .
 . . . . S . . . . .
 . . . . . . . . . .
