 . . . 3 . . . . 4 4
 . . . 3 . M . . . .
 . . . 3 . . . . . .
 . . . . . . . . . .
 . . . 1 1 1 1 . . .
 0 . . . . . . . . .
 0 . . . . . . . . .
 0 . . . . . . . 2 .
 0 . . . . . 2 2 2 .
 0 . . . . . . . S .
