 . . . . 0 0 0 0 0 .
 . . . . . . . . . .
 3 3 3 3 . . . S . .
 . . . . . . . . . .
 . . . . . . . . . .
 . . . . . . . . . .
 1 1 1 1 . . . . . .
 . . . . . . 2 . 4 .
 . . . . . . 2 . 4 .
 M . . . . . 2 . . .
