 2 . . . . . . . M .
 . 2 . . . . S . . .
 . . 2 . . 0 . . . .
 . . . . . . 0 0 0 .
 3 . . . . 0 . . . .
 . 3 . . . . . . . .
 . . 3 . . 1 . . 4 4
 . . . . 1 . 1 . 4 .
 . . . . . 1 . . . .
 . . . . . . . . . .
