 . 0 . . 2 2 2 . . .
 . . 0 . . . . . 4 .
 . S 0 . . . . . 4 .
 . . 0 . . . . . . .
 . . 0 . . 3 3 3 . .
 M . 0 . . . . . . .
 . . . . . . . . . .
 . . . . . . . . . .
 . . . 1 1 1 1 . . .
 . . . . . . . . . .
