 . . . . . . . . . .
 . . . . 1 1 . 4 . .
 . . . . 1 1 . 4 . .
 . . . . . . . . . .
 . . . 0 . . . . . .
 2 . 0 0 0 . S . . .
 2 . . 0 . . . . . .
 2 . . . . 3 3 3 . .
 2 . . . . . . . . .
 . . . . . . M . . .
