 . . . . . . . . . .
 . . . . . . 1 . . .
 2 . . . . . 1 . . .
 . 2 2 2 . . 1 . . .
 . S . . . . 1 . . M
 . . . . . . . . . .
 . 0 0 0 0 0 . . . .
 . . . . . . . . . .
 . . . . 3 3 3 . . .
 . 4 4 . . . . . . .
