 . . 1 . . . . S . .
 . 1 . 1 . . . . . .
 . . 1 . . . . . . M
 . . . . . . . . . .
 . . . . . . 0 . . .
 . . . 0 0 0 . . . .
 . 2 . . . . 0 . . .
 2 . . 3 . . . . . .
 . 2 . . 3 . . . . .
 . . 2 . . 3 . 4 4 .
