 . 2 2 2 . . 1 . . .
 . . . . . . 1 . . .
 . . . . . . 1 . . .
 . . . . . S 1 . . .
 . . . . . . 1 . . .
 . . . . . . . . . .
 . 4 4 . 3 3 3 . . M
 . . . . . . . . . .
 . . . . . . . . . .
 . . . 0 0 0 0 0 . .
