 . . . . . . S . . .
 . . . 0 . . . . 1 .
 . . . 0 . . . . 1 .
 . . . 0 . 4 4 . 1 .
 . M . 0 . . . . 1 .
 . . . 0 . . . . . .
 . . . . . . 3 . . .
 . 2 2 2 . 3 3 3 . .
 . . . . . . . . . .
 . . . . . . . . . .
