 . . . . . 4 4 . . .
 . M . . . . . . . 2
 . . . 3 . . . . 2 .
 . 0 . . 3 . . 2 . .
 . 0 . . . 3 . . . .
 . 0 . . . . . 1 . .
 0 . 0 . . . 1 . 1 1
 . . . . . . . 1 . S
 . . . . . . . . . .
 . . . . . . . . . .
