 . . 3 . . . . . . .
 . . 3 . . . 1 1 1 1
 . . 3 . . . . . . .
 . . . . . . . . . 4
 . M . . . . . . . 4
 . . . . . . . . S .
 2 2 2 . . 0 0 0 0 0
 . . . . . 0 . . . .
 . . . . . . . . . .
 . . . . . . . . . .
