 . 3 . . . . . . . .
 . 3 . 4 4 . 2 2 2 .
 . 3 . . . . . . . .
 . . . . . . . . . .
 . . . . . . . . 1 .
 . . 0 . . . . . 1 .
 . . 0 . . . . . 1 .
 . . 0 . . . . 1 1 .
 . . 0 . S . . . . .
 . . 0 . . . . M . .
