 . . . . . . . . . .
 . . . . . 0 0 . . 2
 . . . . 0 0 0 . . 2
 . . . . . 0 . . . 2
 1 1 . S . . . . . .
 1 1 . . . . . . . .
 . . . . 4 . . . . .
 3 . M . 4 . . . . .
 3 . . . . . . . . .
 3 . . . . . . . . .
