 . . . . 3 . . . . .
 . 0 . . 3 . . . . .
 . 0 . . 3 . . . . .
 . 0 . . . . . . . .
 . 0 . . . . . 2 . .
 . 0 . . . . 2 . . .
 . . . M . . 2 . . .
 . . . . . . 2 . . .
 1 1 1 1 . . . . . .
 . . . . S . . . 4 4
