 . . . . . . . . . .
 . . . . . . . 0 . .
 . . . . . . . 0 . 3
 . . M . . . . 0 . 3
 . . . . . . S 0 . 3
 1 1 1 1 . . . 0 . .
 . . . . . 2 . . . .
 . . . . . 2 . . . .
 . 4 . . . 2 . . . .
 . 4 . . 2 . . . . .
