 4 4 . . 0 . 0 . . 3
 4 . . . . 0 . . 3 .
 . . . M . 0 . 3 . .
 . . . . . 0 . . . .
 . . . S . . . . . .
 . . 2 . . . . . 1 .
 . . . 2 . . . 1 . 1
 . . . . 2 . . . 1 .
 . . . . . . . . . .
 . . . . . . . . . .
