 . . . . . . 1 . . .
 . . . M . 1 . 1 . .
 0 . . . . . 1 . . .
 . 0 0 0 . . . . . .
 0 . S . . . . . . .
 . . . . . . . . . .
 . . 3 . . . . . . .
 . . . 3 . . 2 . . .
 4 . . . 3 . 2 2 . .
 4 . . . . . . . 2 .
