 . . . . . . . 3 . .
 4 4 . . . . . . 3 .
 . . . . . . 1 . . 3
 . . . . . 1 . . . .
 . . . . 1 . 1 . . .
 . . 0 . . 1 . . . .
 . . 0 . . . . . . M
 . . 0 . . . 2 . S .
 . 0 . 0 . . . 2 . .
 . . . . . . . . 2 .
