 . . M . . . 1 . . .
 . . . . . 1 . 1 . .
 2 . . . . . 1 . . .
 . 2 . . . . . . . .
 . . 2 . . . . 3 . .
 . . . 2 . S 3 . . .
 . . . . . 3 . . . .
 . . . . . . . . 0 .
 . 4 4 . . 0 0 0 . .
 . . . . . . . . 0 .
