 . . 0 . . . . . . .
 . . 0 . M . . . . .
 S . 0 . . . . . . .
 . 0 . 0 . . . . 4 4
 . . . . . . 1 . . .
 . . . . . 1 . 1 . .
 . . . . . . 1 . . .
 . . 2 . . . . . . 3
 . . . 2 . . . . 3 .
 . . . . 2 2 . 3 . .
