 . . . . . . . . . .
 . 1 1 . . . . . . 2
 . 1 1 . . . . . . 2
 . . . . . . . . . 2
 3 3 3 3 . . . . . .
 . . . . . . . . S .
 . . . . . . . 4 4 .
 M . . . 0 . . . . .
 . . . 0 0 0 . . . .
 . . . . 0 . . . . .
