 . . . . . . M . . .
 . 2 . . . . . . . .
 . 2 . . . . . 3 3 3
 . 2 . . . . . . . .
 . . . . . . . . . .
 . . . 0 . . . . . 1
 . . 0 0 0 . S 1 1 .
 . . . 0 . . . 1 1 .
 . 4 . . . . . . . .
 . 4 . . . . . . . .
