 . . . . . . 3 . . .
 . . . . . 3 . . . .
 . . 4 . 3 . . . . .
 . . 4 . . . . . 1 .
 . . . . 0 . . 1 . 1
 . 0 0 0 . . . . 1 .
 . . S . 0 . 2 . . .
 . . . . 0 . . 2 . .
 . . . . . . . . 2 .
 . . . M . . . . . .
