 . . . . . . 3 3 3 .
 . . . . . . . . . .
 . . . . . . . . 0 .
 . . . . . . . 0 0 0
 . . . . . . . . 0 .
 2 . . . . . . . . .
 2 . 1 1 . . M . . .
 2 S 1 1 . . . . . .
 2 . . . . . . . . .
 . . . . . . . 4 4 .
