 . . . . 0 . . . 1 .
 . 0 0 0 . . . 1 . 1
 . . . . 0 . . . 1 .
 . . . . . S . . . .
 . . . . . . . . . .
 . . . . . . . M . .
 . . 2 . . . . . . .
 4 . . 2 . . . 3 . .
 4 . . . 2 . . . 3 .
 4 . . . . . . . . 3
