 . . . . . . . 4 . .
 1 1 . . . . . 4 . .
 1 1 . . . 0 . . . .
 . . . . 0 0 0 . . .
 . . M . . 0 . . . .
 . . . . . . . . 2 .
 . . . . . . . . . 2
 . . S . . . . . . 2
 . 3 3 3 . . . . . 2
 . . . . . . . . . .
