 . 0 . . . . . . . .
 . 0 . . 3 . . 1 . .
 . 0 . . 3 . . 1 . .
 0 0 . . 3 . . 1 . .
 . 0 . . . . . 1 . .
 . . . . . . . . . .
 . 2 2 2 . . . . . .
 . . . . . . . . . .
 . . . 4 . . . M . .
 . . . 4 . . S . . .
