 2 . . . . . 3 3 3 .
 2 . 4 . . . . . . .
 2 . 4 . . . . . . .
 . . . . . S . . . .
 . . . . 1 1 1 1 1 .
 . . . . . . . . . .
 . . . . . . . . . .
 . . 0 0 0 0 0 . . .
 . . . . . . . . . .
 . . . . . . . . . M
