 . . . . . . . . . S
 . 1 . . . . . M . .
 . 1 . . . . . . . .
 . 1 . . 0 . . . 3 3
 . 1 . . 0 . . . . 3
 . . . . 0 . . . . 3
 . 4 4 . 0 . 2 . . .
 . . . . 0 . 2 . . .
 . . . . . . 2 . . .
 . . . . . . . . . .
