 . . . . . . . . . .
 . 2 . . . . . 1 . .
 . . 2 . . . 1 . 1 .
 . . . 2 . . . 1 . .
 3 . . . . . . . . .
 . 3 . . 0 . . . . .
 . . 3 . . 0 0 0 . .
 . . . . 0 . . 0 . .
 . 4 4 . . . . S . .
 . . . . M . . . . .
