 . . . 1 . . . . . 3
 . . 1 . 1 . . . 3 .
 . . . 1 . 1 . 3 . .
 . . . . . . . . . .
 . . . . 4 . . . 2 .
 . . . . 4 . . 2 . .
 M . . . . . 2 . . .
 . . . 0 . . . . . .
 . . . . 0 0 0 . . .
 . . . 0 . . . . S .
