 3 3 3 3 . . . . . .
 . . . . . . S . . .
 . . . 1 1 1 1 . . .
 . . . . . . . . . .
 . . . . . 0 . . . .
 . . . . . 0 . . 4 4
 . . . . . 0 . . . .
 . . . . . 0 . . 2 .
 . . M . . 0 . . 2 .
 . . . . . . . . 2 .
