 . . . . . 3 . . . .
 0 . . . . . 3 . . .
 . 0 0 0 . . . 3 . .
 0 . . . . 1 . . . .
 . . . . 1 . 1 . . .
 . . . . . 1 . . 4 4
 . . . . . . . . . .
 . . . . . . 2 2 . .
 . . . . . 2 . . . .
 M . . . 2 . S . . .
