 M . . . 4 . . . . .
 . . . . 4 . . 2 . .
 . . . . . . 2 . . .
 . . . . . 2 . . . .
 . 1 . . . . . 0 . 0
 1 . 1 . . . . . 0 .
 . 1 . . 3 . . . 0 .
 . . . . . 3 . . 0 S
 . . . . . . 3 . . .
 . . . . . . . 3 . .
