 . . . . . . . . . .
 . . . 0 . 0 . . . .
 . . . . 0 S . . 4 .
 . . . . 0 . 4 4 . .
 . . 3 . 0 . . . . M
 . 3 . . . . . 1 . .
 3 . . . . . 1 . 1 .
 . . 2 . . . . 1 . .
 . 2 . . . . . . . .
 2 . . . . . . . . .
