 . . . . . . 1 . . M
 . . . . . 1 . 1 . .
 . . 0 . . . 1 . . .
 . . 0 . . . . . . .
 . . 0 . . . . . . .
 . 0 . 0 . . . 2 . .
 . . . . . . . . 2 .
 . . . . 3 . . . . 2
 S . . . . 3 . . . .
 4 4 . . 3 . 3 . . .
