 . . . . . . . M . .
 . . . . . . . . . .
 . . . . . . . . . .
 . . . . . 3 . . 1 .
 . . . . 3 . S 1 . 1
 . 0 . 3 . . . . 1 .
 . 0 . 3 . . . . . .
 . 0 . . . 2 . . . .
 0 . 0 . . . 2 . . 4
 . . . . . . . 2 . 4
