 . 0 0 0 0 0 . . 2 .
 . S . . . . . . 2 .
 . . . . . . . . 2 .
 . . . . . 4 4 . . .
 . . . . . . . . . .
 . . . . . . . . . .
 . 1 . . . 3 . . . .
 . 1 . . . . 3 3 3 .
 . 1 . . . . . . . .
 . 1 . . M . . . . .
