 . . . 1 . . . . . .
 . 1 1 . . . . . . .
 . 1 1 . . 0 . . . .
 . . . . 0 0 0 . . .
 . . . . . 0 . . . 3
 2 . . . . . . . . 3
 2 . . . . . . . . 3
 2 S . 4 4 . . M . .
 . . . . . . . . . .
 . . . . . . . . . .
