 . 4 4 . . . . . . .
 . 4 . . . 1 . . . .
 . . . S 1 . 1 . . .
 . . 0 . . 1 . . . .
 . . 0 . . . . 3 . .
 . . 0 . . . . . 3 .
 . 0 . 0 . 2 . . . 3
 . . . . . . 2 . . .
 . . . . . . . 2 . .
 . M . . . . . . . .
