 . . . 0 0 . . . . .
 . . . 0 0 0 . . . .
 . . . . 0 . . . . .
 . . . . . . . S . .
 . . . . 1 1 . . . .
 . . . . 1 1 . . . .
 . . . . . . . 4 . 2
 . . . . . 3 . 4 . 2
 . . . . . 3 . . . 2
 . M . . . 3 . . . .
