 . . . . . . . . . .
 . . . . 0 0 0 0 0 .
 . . . . . . . . . .
 . 1 . . . . . . . .
 . 1 . . . . 2 S . .
 . 1 . . . . 2 . . .
 . 1 . . . . 2 2 . .
 . . . . . . . . . .
 . . . . . . 4 . . .
 . 3 3 3 . . 4 . M .
