 . 3 3 3 . . . . . .
 . . . . . . . . . .
 . . . 2 2 2 . . 4 .
 . . . . . . . . 4 .
 . . 0 . . . . . . 4
 . . 0 . . . . . . .
 . . 0 . . . . 1 . S
 . . 0 . . . . 1 . .
 . . 0 . . . . 1 . M
 . . . . . . . 1 . .
