 . . 2 . . . . . . .
 . . 2 . . . . . . .
 . . 2 . 1 . . . . .
 . . . . 1 . . 0 . .
 4 4 . . 1 . . 0 . .
 . S . . 1 . . 0 . 3
 . . . 1 . . . 0 . 3
 . . . . . . . 0 . 3
 . . . . . . . . . .
 . . . . . . M . . .
