 . . . 2 . . . . . 1
 . . . . 2 . . . . 1
 . . . . 2 . . . . 1
 . 3 . . 2 . . . . 1
 . 3 . S . . . . . .
 . 3 . . . . . . . .
 . . . . . 0 0 0 0 0
 . . . . . . . . . .
 . . . . . . . . . 4
 . . . . M . . . . 4
