 . . . . 0 . . . . .
 . 0 0 0 . . . . . .
 . . S . 0 . . 1 . .
 . . . . . . 1 . 1 .
 . . . 2 . . . 1 . .
 . . 2 . . M . 1 . .
 . 2 . . . . . . . .
 . . . 4 . . . . 3 .
 . . . 4 . . . 3 . .
 . . . . . . 3 . . .
