 . . . . . . . . . .
 . . . . . . . . . .
 . . . . . . . . . .
 . . . . . S . M . 4
 . . . 0 . . . . . 4
 . . 0 0 0 . . . . .
 3 . . 0 0 . 1 1 . .
 3 . . . . . 1 1 . .
 3 . . . . . . . . .
 . . . . 2 2 2 . . .
