 . 2 2 2 2 . . . . .
 . . . . . . . M . .
 . . . . . . . . . .
 . . . . . . . 1 1 .
 . . . . . . . 1 1 .
 . . . . 4 4 . . . .
 . . . . . . . . . .
 . 3 . . . . . 0 . .
 . 3 . . . . 0 0 0 .
 S 3 . . . . . 0 . .
