 . . . 4 4 . S . . .
 . . . . . . . . . .
 . 2 . . . . 0 . . .
 . . 2 . . . 0 . . .
 . . . 2 . . 0 . . .
 M . . . . . 0 . . .
 . . . . . 0 . 0 . .
 . 1 . . . . . . . 3
 1 . 1 . . . . . 3 .
 . 1 . . . . . 3 . .
