 . . . . . . . . . .
 1 . . 2 S . 3 3 3 .
 1 . . 2 . . . . . .
 1 . . 2 . . . . . .
 1 . . . . . . . . .
 . . . . . . . . . .
 0 0 0 0 0 0 . . . .
 . . . . . . . . . .
 . . M . . . . 4 . .
 . . . . . . . 4 . .
