 . 1 . . . . . . . .
 . 1 1 1 1 . . . . .
 . . . . . . . . . .
 . . . . . . . . . .
 . 2 2 2 . . 0 . . .
 . . . . . . 0 . . .
 . . 3 3 3 . 0 . . .
 . . . . S . 0 . . .
 . . . . 4 . 0 . . .
 . . . . 4 . . . . M
