 . . 2 . 3 . . . . .
 . 2 . . . 3 . . . .
 2 . . . . . 3 . . .
 . . . 0 . . . . M .
 . . . . 0 0 0 . . .
 . . . 0 . 0 . S . .
 . 4 . . . . . . . .
 . 4 . . . 1 . . . .
 . . . . 1 . 1 . . .
 . . . . . 1 . . . .
