 . . . 3 3 3 . . . .
 . . . . . . . . . .
 . . . . . . 2 . . .
 . . . 4 . 2 . . . .
 . . . 4 . 2 S . M .
 . . . . . 2 . . . .
 . . . . . . . . . .
 . . . . 0 0 0 0 0 .
 . . . . . . . . . .
 1 1 1 1 . . . . . .
