 . . 4 4 . . . 2 . .
 . . . . . . . 2 . .
 S 0 . . . . . 2 . .
 . 0 . 3 3 3 . . . .
 . 0 . . . . . . . .
 . 0 . . . . . . . .
 . 0 . . . . . . . .
 . . . . . . . . . .
 . . . . 1 . . M . .
 . 1 1 1 1 . . . . .
