 . . . 3 . M . . . .
 . . . 3 . . . 2 . .
 . . . 3 . . . 2 . .
 . 1 . . . . . 2 S .
 . 1 . . . . . . . .
 . 1 . . . . . . . .
 . 1 . . . . 4 . . .
 . . . . . 4 4 . . .
 . . . . . . . . . .
 . . . . 0 0 0 0 0 .
